kicksled | kicksled
snive | snive
lyze | lyze
halsen | halsen
inviron | inviron
stivot | stivot
tuft | tuft
stanch | stanch
pedant | pedant
morsel | morsel
proc | proc
sandbag | sandbag
whipsaw | whipsaw
fure | fure
larf | larf
netdeck | netdeck
shimmer | shimmer
camisole | camisole
preform | preform
unmother | unmother
domesticate | domesticate
commerce | commerce
conjoin | conjoin
bayonet | bayonet
mortar | mortar
chronicle | chronicle
seek | seek
ricket | ricket
stunt | stunt
drash | drash
facepalm | facepalm
phase | phase
precept | precept
degauss | degauss
counterweight | counterweight
saye | saye
kisse | kisse
trank | trank
autocorrect | autocorrect
outflow | outflow
daff | daff
fuel | fuel
fley | fley
boymode | boymode
lesion | lesion
wherret | wherret
dross | dross
light | light
cite | cite
chromakey | chromakey
mention | mention
backbite | backbite
pelter | pelter
counterpressure | counterpressure
attribute | attribute
boad | boad
find | find
calamine | calamine
tail | tail
breyde | breyde
ai | ai
jigsaw | jigsaw
rattan | rattan
molluscicide | molluscicide
overtype | overtype
dood | dood
quære | quære
untaste | untaste
counterwork | counterwork
megadose | megadose
jinx | jinx
concoct | concoct
phagocytose | phagocytose
chinch | chinch
cupcake | cupcake
travesty | travesty
smash | smash
siteban | siteban
horsewhip | horsewhip
tee | tee
debilitate | debilitate
abandon | abandon
groundtruth | groundtruth
aston | aston
beggar | beggar
whoost | whoost
acrospire | acrospire
alter | alter
steamroller | steamroller
piano | piano
excommunicate | excommunicate
puppy | puppy
orphan | orphan
javelin | javelin
schlenter | schlenter
geranylate | geranylate
overstride | overstride
slobber | slobber
grasshopper | grasshopper
backcheck | backcheck
shortcut | shortcut
yaffle | yaffle
espy | espy
hero | hero
dropkick | dropkick
moustachio | moustachio
kelk | kelk
schottische | schottische
backpocket | backpocket
basen | basen
poke | poke
amuse | amuse
crandall | crandall
reshuffle | reshuffle
trill | trill
reflush | reflush
zouk | zouk
sprunt | sprunt
countervote | countervote
cyanate | cyanate
put | put
rescript | rescript
laxen | laxen
flexure | flexure
scream | scream
mistalk | mistalk
miss | miss
dedent | dedent
twank | twank
croup | croup
overissue | overissue
dent | dent
tippytoe | tippytoe
comfit | comfit
downsweep | downsweep
advoke | advoke
jap | jap
eyewitness | eyewitness
barricado | barricado
iris | iris
stoccade | stoccade
gotter | gotter
clapboard | clapboard
vire | vire
longboard | longboard
machinofacture | machinofacture
bench | bench
topcode | topcode
barrier | barrier
jangle | jangle
chokehold | chokehold
freeski | freeski
lube | lube
preslice | preslice
begin | begin
handplane | handplane
yen | yen
swike | swike
fluff | fluff
plover | plover
item | item
banquet | banquet
subtag | subtag
mistressmind | mistressmind
hairdress | hairdress
redirect | redirect
dyb | dyb
frollick | frollick
psychograph | psychograph
meter | meter
wheelie | wheelie
skew | skew
outgo | outgo
goober | goober
misfeed | misfeed
garter | garter
creance | creance
teare | teare
plump | plump
librate | librate
troop | troop
laik | laik
wok | wok
retrotransfer | retrotransfer
color | color
unpower | unpower
renegade | renegade
overdate | overdate
downhill | downhill
ontake | ontake
lam | lam
sleaze | sleaze
drawknife | drawknife
upcycle | upcycle
overpurchase | overpurchase
hearse | hearse
joll | joll
roughneck | roughneck
headline | headline
tin | tin
doubletime | doubletime
pomp | pomp
point | point
outguard | outguard
progress | progress
divel | divel
involute | involute
diurese | diurese
doompost | doompost
foghorn | foghorn
rebleed | rebleed
ticktack | ticktack
perve | perve
descend | descend
shew | shew
catalog | catalog
chupse | chupse
geomance | geomance
fratch | fratch
free | free
toboggin | toboggin
cruck | cruck
visé | visé
bant | bant
lowercase | lowercase
aeroplane | aeroplane
underwire | underwire
trape | trape
nook | nook
lofe | lofe
curbstomp | curbstomp
stool | stool
deperm | deperm
cable | cable
septuple | septuple
congest | congest
inwork | inwork
vee | vee
kiki | kiki
souce | souce
smelt | smelt
ante | ante
preeve | preeve
geocode | geocode
micro | micro
tooth | tooth
overproof | overproof
præsent | præsent
ad. | ad.
spane | spane
invert | invert
sab | sab
vie | vie
overhaul | overhaul
skuttle | skuttle
blowe | blowe
postcode | postcode
backlog | backlog
overmeasure | overmeasure
reorg | reorg
tare | tare
institute | institute
cut | cut
phantasie | phantasie
bat | bat
prestudy | prestudy
chemostat | chemostat
emerald | emerald
overflower | overflower
scrounge | scrounge
unend | unend
tollgate | tollgate
blarny | blarny
squabble | squabble
ettle | ettle
restreak | restreak
omelette | omelette
scarper | scarper
creed | creed
rebluff | rebluff
trigger | trigger
yeast | yeast
nether | nether
jam | jam
yicker | yicker
clearcole | clearcole
waive | waive
counterenamel | counterenamel
fatten | fatten
multiload | multiload
slock | slock
career | career
namecheck | namecheck
run | run
fill | fill
physic | physic
microcentrifuge | microcentrifuge
saught | saught
babymoon | babymoon
settle | settle
calm | calm
graff | graff
subaverage | subaverage
twattle | twattle
maneuver | maneuver
guttle | guttle
sorn | sorn
divise | divise
sweet | sweet
onrush | onrush
pseudomorph | pseudomorph
brandmark | brandmark
lapdance | lapdance
polish | polish
yodle | yodle
swaddle | swaddle
despect | despect
ballyhoo | ballyhoo
hone | hone
ravin | ravin
helicopter | helicopter
mete | mete
beta | beta
subfix | subfix
flower | flower
yarn | yarn
lox | lox
fable | fable
fist | fist
spork | spork
educe | educe
scrim | scrim
brand | brand
picnic | picnic
crane | crane
supper | supper
overrate | overrate
hc | hc
backset | backset
obsolete | obsolete
korero | korero
premiere | premiere
misguggle | misguggle
clit | clit
jet | jet
mousse | mousse
overword | overword
gangrape | gangrape
chate | chate
dretch | dretch
steen | steen
shmoose | shmoose
pretty | pretty
paragraph | paragraph
headshot | headshot
compile | compile
safeguard | safeguard
genogroup | genogroup
bother | bother
iterate | iterate
pie | pie
overlight | overlight
worrit | worrit
girt | girt
folf | folf
overcheck | overcheck
batik | batik
cheek | cheek
phoenix | phoenix
scote | scote
wallride | wallride
quadreble | quadreble
hektograph | hektograph
demaunde | demaunde
crupper | crupper
decan | decan
stig | stig
hyde | hyde
precontract | precontract
nicker | nicker
rend | rend
ticket | ticket
thole | thole
intercross | intercross
mitre | mitre
stereograph | stereograph
foot | foot
overcoat | overcoat
pilm | pilm
moonwalk | moonwalk
allonge | allonge
mailshot | mailshot
lariat | lariat
metaphrase | metaphrase
oversample | oversample
margent | margent
fleck | fleck
slice | slice
prodnose | prodnose
kipe | kipe
overlook | overlook
toil | toil
gnag | gnag
beg | beg
hydrofoil | hydrofoil
rush | rush
motive | motive
nock | nock
minge | minge
pasquin | pasquin
threep | threep
spy | spy
undrain | undrain
spline | spline
misview | misview
crut | crut
be | be
commission | commission
hare | hare
imperfect | imperfect
jenny | jenny
preamble | preamble
velure | velure
calcinate | calcinate
quitch | quitch
undervolt | undervolt
prologue | prologue
geotag | geotag
roundhouse | roundhouse
slop | slop
bool | bool
farce | farce
mar | mar
tek | tek
cue | cue
enamel | enamel
subaward | subaward
gem | gem
footfuck | footfuck
w*nk | w*nk
blob | blob
poor | poor
mug | mug
musk | musk
automobile | automobile
redownload | redownload
support | support
remake | remake
bodyguard | bodyguard
absciss | absciss
parasail | parasail
smeech | smeech
rapine | rapine
gab | gab
ransack | ransack
repeal | repeal
heap | heap
misdoubt | misdoubt
grip | grip
lovebird | lovebird
reservoir | reservoir
kafkatrap | kafkatrap
miniature | miniature
tapeworm | tapeworm
earn | earn
pal | pal
bavin | bavin
cog | cog
mischarge | mischarge
skrike | skrike
veil | veil
stent | stent
drift | drift
jackass | jackass
soogee | soogee
trophy | trophy
rotavape | rotavape
jostle | jostle
dy | dy
oblong | oblong
chandelle | chandelle
overhold | overhold
coggle | coggle
f…k | f…k
skiffle | skiffle
crosshaul | crosshaul
discountenance | discountenance
swallie | swallie
shambok | shambok
do | do
buckle | buckle
coiffe | coiffe
wheatpaste | wheatpaste
mothball | mothball
flabberghast | flabberghast
hiccup | hiccup
jackeroo | jackeroo
clay | clay
garland | garland
roadblock | roadblock
timebox | timebox
precum | precum
dilute | dilute
postdate | postdate
whittle | whittle
helm | helm
outcut | outcut
conference | conference
ammoniate | ammoniate
tod | tod
flagship | flagship
administer | administer
underissue | underissue
endorse | endorse
creak | creak
bunko | bunko
handwave | handwave
holdback | holdback
upbend | upbend
rottenstone | rottenstone
ranch | ranch
pigstick | pigstick
quadrate | quadrate
carve | carve
transsex | transsex
bonfire | bonfire
bracelet | bracelet
bit | bit
wane | wane
borrow | borrow
mix | mix
postdecrement | postdecrement
cleave | cleave
shrag | shrag
astore | astore
foreglance | foreglance
limetwig | limetwig
trope | trope
frustrate | frustrate
noscope | noscope
seenzone | seenzone
hydrolyse | hydrolyse
pern | pern
bearhug | bearhug
cumulate | cumulate
retrofocus | retrofocus
sam | sam
flounder | flounder
saffron | saffron
policy | policy
slum | slum
retrofit | retrofit
lob | lob
greenwash | greenwash
bite | bite
immunoassay | immunoassay
consense | consense
whale | whale
housecall | housecall
webstream | webstream
gittern | gittern
macrocode | macrocode
act | act
fleece | fleece
flipflop | flipflop
enfilade | enfilade
blackpill | blackpill
judder | judder
at | at
company | company
pallet | pallet
chunam | chunam
overcharge | overcharge
edder | edder
flashback | flashback
consequence | consequence
selfharm | selfharm
zhoozh | zhoozh
vein | vein
rather | rather
peaktrans | peaktrans
quahaug | quahaug
convive | convive
trapan | trapan
fillet | fillet
fute | fute
stale | stale
medivac | medivac
cuss | cuss
figure | figure
break | break
shephard | shephard
complex | complex
groin | groin
frostbite | frostbite
frill | frill
warrant | warrant
entrain | entrain
abut | abut
fap | fap
tricycle | tricycle
mast | mast
steady | steady
ballocks | ballocks
bolk | bolk
foster | foster
polygraph | polygraph
florysh | florysh
smouse | smouse
washer | washer
feedforward | feedforward
thickness | thickness
agitprop | agitprop
mow | mow
bib | bib
disentail | disentail
rejoinder | rejoinder
kindle | kindle
misestimate | misestimate
kid | kid
increase | increase
refuse | refuse
traunch | traunch
comma | comma
stownd | stownd
radiotag | radiotag
backchat | backchat
pension | pension
taw | taw
chauffeur | chauffeur
mango | mango
undertime | undertime
gangster | gangster
skinch | skinch
plow | plow
boss | boss
holla | holla
overfold | overfold
gazetteer | gazetteer
dispatch | dispatch
milkshake | milkshake
blackberry | blackberry
mordant | mordant
overwind | overwind
scholy | scholy
substring | substring
water | water
cablecast | cablecast
bewit | bewit
pontificate | pontificate
decimal | decimal
overexercise | overexercise
staine | staine
eisegete | eisegete
muffin | muffin
challan | challan
covermount | covermount
monkeypatch | monkeypatch
thrift | thrift
decrypt | decrypt
soapbox | soapbox
treebank | treebank
alibi | alibi
revision | revision
hashtag | hashtag
rouge | rouge
tailspin | tailspin
gaiter | gaiter
cacodylate | cacodylate
correct | correct
armbar | armbar
wheeze | wheeze
officiate | officiate
nuss | nuss
headspace | headspace
doodle | doodle
lifen | lifen
dispurvey | dispurvey
hopscotch | hopscotch
rewatch | rewatch
chitchat | chitchat
stowse | stowse
dup | dup
handline | handline
balm | balm
scabbard | scabbard
sample | sample
grain | grain
tut | tut
withe | withe
forecharge | forecharge
binge | binge
cotise | cotise
eustress | eustress
howitzer | howitzer
dec | dec
noseprint | noseprint
snifter | snifter
hound | hound
dither | dither
luigi | luigi
sax | sax
hoedown | hoedown
outrun | outrun
pummel | pummel
sneed | sneed
surmise | surmise
throat | throat
wit | wit
motormouth | motormouth
scorse | scorse
oyster | oyster
interconnect | interconnect
maul | maul
footshock | footshock
gillie | gillie
farse | farse
carcoon | carcoon
pommel | pommel
away | away
bioprocess | bioprocess
bamboo | bamboo
imp | imp
evidence | evidence
expense | expense
waft | waft
wonk | wonk
decharter | decharter
prolog | prolog
doodie | doodie
dit | dit
smile | smile
aspect | aspect
précis | précis
telemark | telemark
laze | laze
squawl | squawl
squink | squink
wive | wive
skee | skee
underline | underline
strangle | strangle
hoon | hoon
fungo | fungo
crawfish | crawfish
bags | bags
hew | hew
microchip | microchip
shitcan | shitcan
noun | noun
hob | hob
sark | sark
famble | famble
gots | gots
wiseacre | wiseacre
vac | vac
underhook | underhook
uproot | uproot
bauchle | bauchle
abode | abode
superfat | superfat
ampersand | ampersand
rabate | rabate
heliograph | heliograph
glob | glob
flock | flock
warraunt | warraunt
skiddoo | skiddoo
sun | sun
notice | notice
habit | habit
shivari | shivari
hearthstone | hearthstone
raff | raff
compilate | compilate
branch | branch
edgelord | edgelord
bluewash | bluewash
plotter | plotter
missee | missee
duchen | duchen
miswrap | miswrap
parachute | parachute
ragdoll | ragdoll
plash | plash
collogue | collogue
pheese | pheese
hamster | hamster
pillory | pillory
tootle | tootle
noddy | noddy
luck | luck
ride | ride
thwonk | thwonk
jibe | jibe
namefag | namefag
gulley | gulley
nappe | nappe
handset | handset
girl | girl
inoculate | inoculate
equipage | equipage
wigwag | wigwag