die	death, dead, dying, deceased
win	winner, win
be	being
survive	survivor, survival, soldier, survive, species
fail	failure, fail, failing, failed, former, first
succeed	success, successful, student
live	living, latter
pass	pass, passing, pedestrian, passer, person, passenger
do	do, doctor
cry	cry, crying, child
know	
fall	fall, falling, first, former, form
work	worker
leave	latter, leave, last, leaving
not	name, noun, not
come	customer, client
return	return, regular, resident
lose	loss, loser, losing, lose, lost, latter
stay	stay, second
bite	bite, biting, bitten, bully, bit
tell	tell, term, telling
answer	answer, a, administrator, amen, above, acronym
try	try, term, trainer, test
explode	explosive, explosion, explode, exploded, exploding, explodes, explosives, expert
disappear	disappearance
go	gym
fly	flyer, following, first, fly, former, flight, fighter
happen	
help	helper, help
run	runner, run, running, regular, runners
respond	response, rt, r, recipient, reply, respondent, regular
sue	sue, sued, suit, suing
change	change
remember	recall, remembering, remember
last	last, latter, lifetime, letter
too	term, title
eat	eater, enthusiast
have	
listen	listener, listen, listening, latter, label
pay	patron
miss	miss, missing, missed
understand	understanding, user
retire	retirement, retire, retired, retiring
suffer	suffering, survivor
see	second
talk	term
recover	recovery, remission, recovering, recover
starve	starving, starvation, starved
learn	latter
say	speaker
wait	waiter, wait
stop	stop, symbol
scream	scream, screaming, singer, screamed
remain	resident, regular
finish	finish, following, first
rise	rise, rose, rising
break	break, breaker, broken, breaking, broke
follow	follower, follow, following, fan, follows, first
quit	quit, quitting
lie	liar, lie, lying, lies, latter
disagree	disagreement, disagree, dissent
graduate	graduate, grad, graduation
burn	burn, burner, burning, burned
end	employee, e
laugh	laugh, laughing, laughter, latter
strike	strike, striking, striker, symbol, strikes
smile	smile, smiling, smiled, smiles, symbol
hurt	hurt, hurting
call	caller, call, customer, contact
walk	walk, word
deliver	delivery, driver, deliver, distributor
ask	ask, asking, asked, admin, a, asks, answer, above
prevail	person
stick	stick, symbol, spokesperson
sleep	sleeper, sleep
apologize	apology, apologize, apologizing, apologized, apolog, apologies, administrator, acronym, above
explain	educator, expert, editor, employee
kill	kill, killer, killing
perish	person
write	writer
vomit	vomiting, vomit
speak	speaker
fold	fold, folding, folded, f, form, first, foil, folds, farmer, fly
agree	agreement, agreed, administrator, adherent, accountant, average, agree, above, acronym, adjective
drown	drowning, drown, drowned, diver, death
suffice	symbol
care	caring, care
resign	resignation, resign
exist	existence, example, e, extra, entity
teach	teacher, term, title, teaching
never	noun, name, nobody
testify	testimony, term, testified, testifying, testify, title
collapse	collapse, collapsed, collapsing
vanish	vanishing, vanish, vanished
protest	protester, protest, phrase, patriot, protesting
decide	doctor, director
triumph	triumph, term, title
sing	singer, sing, singing
stand	stand, standing, spectator, symbol, sign
rest	rest, resting, runner
count	count, counting, citizen
drink	drunk, drink, drinking
continue	
crash	crash, commuter
escape	escape, escaped, exile, escaping, escapes, exception
fight	fighter, first, fight, following, former
heal	healer, heal, healing, healed
blink	blink, blinking, blinked, blue
soon	symbol
show	show, symbol
refuse	refuse, refusal, reject, refusing, refused
choose	conscientious, customer
move	move, moving
watch	watch
shine	star, shine, superstar, standout, sun
matter	mp, member
think	thinker, term, thought
now	name, now
emerge	example
grow	garden, grass, growth, genus
visit	visitor, visit
play	player, professional, pro
fit	fit, form, following, fitting
suck	suck, sucker, sucking, sucks
burst	burst, bust, bursting, bubble, blister
notice	notice, noticing, name
fade	fade, first, following, former, female
bleed	bleed, bleeding
again	artist, accountant, athlete, atheist, actor, acronym
share	share, sharing, shared
arrive	arrival, attendant, applicant, accountant, a, above
anyway	athlete, accountant, atheist, artist, actor, administrator, acronym
cave	cave, chef
weep	weep, weeping, widow, word
rebel	rebel, rebellion, revolutionary, rebels, rebellious
bail	bail, bailed, bond
forget	forget, forgetting, former
read	reader, read, regular, reading
bolt	bolt, belt, bull
retaliate	r, racist, riot, retaliation
reply	reply, rt, response, reader
crack	crack, cracked, cracking, clean
rule	ruler, rule
resist	resistance, rebel, resist, resisting
appear	actor, artist, appearance, actress, a, alias, above, acronym
appeal	appeal, applicant, appealing, advocate, appellant, above, attorney, appeals, activist, acronym
disappoint	disappointment, disappoint, disappointed, disappointing, d
me	member, mp
freeze	freeze, following, first, freezer, frozen, freak, freezing
pop	pop, popping, phrase, popped, punk
sell	seller
shoot	shooter, sniper, shoot, shooting
eventually	employee, entrepreneur, enthusiast
pray	prayer, priest, phrase, plural
drive	driver, drive, definition
take	term
land	landing, latter, land, landed
complain	complaint, complain, complainant, complaining, critic, complained
thrive	term, thrive
struggle	struggle, struggling, student, survivor
start	starter, start, smoker, student
stink	stink, smoker, sewer
turn	turn, term, turning
comply	compliant, compliance, citizen, commissioner, cop, comply
lead	leader, lead, leadership, latter
succumb	smoker
hope	hope, hopeful, hoping
ever	enthusiast
expire	expired, expiration, expire, employee, extension, entrepreneur, e, esa
hit	hit, hitter
choke	choke, choking, choked, condition, cough
persist	participant, person
vote	voter, vote
make	maker, make
confess	confession, confess, christian, confessed, convert, conscience
snap	snap, snapping, snapped
evolve	evolution, evolutionary, emperor, evolve, evolved, evolving
match	match, mate, matching, member, matched
approve	administrator, admin, accountant, approval, above, acronym
give	giving, give, gift, given
melt	melt, monk, minimalist
endure	exercise, endurance, employee, enthusiast
marry	marriage, married
crumble	crumble, crumbling
decline	decline, depressive, declining, drop, declined, diabetic
always	attendant, adjective, alias
publish	publisher, publication
serve	server, serving, serve, second
manage	manager, management
tweet	term, tweet, twitter, title
close	close
march	march, mc, mp, member, marching
though	term, title
hear	hearing
someday	symbol
react	r, reaction, reactive, react
sign	sign, signature, signing, symbol, subscriber, supporter
look	look, latter
kiss	kiss, kissing, kissed
intervene	intervention
ride	rider, regular, ride
perform	performer, professional, promoter
obey	obedient, obedience, order, obey, officer, orderly, official
hold	holder, hold, holding
settle	settle, settling, settled, suffix, settlement
revolt	rebel, revolt, rebellion, revolutionary, riot
drop	drop, dropping, dropped
join	join
slip	slip, slipped, slips, slipping, skip
attack	attacker, attack, assassin, assailant, aggressive, attacked, acronym
believe	believer, belief, believing, buddhist
travel	traveler, traveller, term, tourist, title
attend	attending, attendance, alumni, attend, auditor, alum, administrator, above, acronym
sink	sink, sinking, symbol, sinks, skip, sewer, student
improve	improvement, improving, improved, individual, instructor
argue	argument, academic, arguing, argue, anarchist, adjective
guess	guess, gp
reconsider	regular
cook	cook, chef
please	please, professional, person, phrase
worry	worry, worried, worrying, word
object	object, offender, owner, observer
qualify	qualifier, qualified, qualifying, qualification, qualify
post	post
judge	judge, judges, judging, judgment, judged
volunteer	volunteer, volunteering, volunteers, volunteered
erupt	eruption, explosion, erupt, explosive, exploding, erupted, example
mourn	mourning, mourn
next	name
relapse	relapse, remission, repeat, recovery
rock	rock
faint	faint, former, first, form
cooperate	cooperative, cooper, collaborator, cooperation, colleague
nap	nap, np, name
propose	proposal, propose, pm, plural, proposing, proposed, person, p, presenter
get	gp, gym
convert	convert, conversion, converts, converted, christian, converting
yield	yield, yielding
benefit	beneficiary, benefit
regret	regret, regrets, regretted, remorse
act	actor, act, artist, actress, acting, accountant, agent, adjective
fry	fry, frying, fried, following, first, fish, fisher
pee	pee, pet, phrase, plural
flee	fugitive, fleeing, flee, former, first, following
comment	commenter, comment, contributor, critic
flip	flip, flipping, flipped, flips, f, first, fan, fl
confirm	
ship	sailor, ship, symbol
bloom	bloom, bud
mind	monk, member, musician
adapt	adaptation, adapt, adapted, adaptive, adapting, agile, adjective, acronym, above
yet	
fire	firefighter, fire, fd, first, following, firearm, fighter
dance	dancer, dance, dj
compete	competitor, champion
shout	shout, shouting, shouted, singer, speaker, smoker
report	report, reported, reporting, reporter, regular
wonder	wonder, word
bomb	bomb, bomber, bombing, belt, blast
pull	pull, pulling, pulled, pulls, pickup
bounce	bounce, bouncing, bunny, bump, bounced
save	save, saving, savings, saved
dominate	dominant, dominate, dominance, dominating, dictator, dom
buy	buyer, buy
blow	blow, blowing, blew, buff
belong	
hang	hang, hung, hanging, hangs
accept	accepted, acceptance, accepting, accept, above, applicant, administrator
sting	sting, symbol, slut, singer
shrink	shrink, sis, surgeon, specialist, shrinking
slide	slide, slip, sliding, student, slope
participate	participant
meet	meeting, member, meet
spread	spread, spreading, suffix, symbol, shepherd
you	
jump	jumper, jump, jumping, jumped
insist	invalid, irregular
leak	leak, leaking, latter, leaked, label, liar, leakage
rot	rot, rat, roast, rotation
rebuild	rebuild, rebuilding, recovery, rebuilt, repair, restoration
check	check, checklist, checking
occur	occurrence, observer, occasional
cease	
apply	applicant, application, above, apply, agent, administrator, academic, acronym
panic	panic, paranoid, phrase, panicked, person
keep	keeper, keep
find	find, finder, first, finding
pick	pick, pickup, picking, professional, plural
bark	bark, barking, bully, boxer, bear
tomorrow	term, title
today	term, title
connect	connection, connect, connector
linger	latter
hesitate	hesitation, hesitant, hesitate
admit	athlete, addict, accountant, alcoholic, atheist, artist, acronym, above
surrender	surrender, surrendered, submission, soldier
smoke	smoker, smoke, symbol, smokers, smoking
arise	accountant, artist, adjective, above, appearance, attendant
tonight	term, title
indeed	individual, irregular
feast	feast, first, festival
bitch	bitch, bully
release	release, releasing, released, releases
bake	baker, bake, bakery, baking, baked, batter
pitch	pitcher, professional, pro, phrase
prosper	prosper
swear	swear, swearing, sailor, swore
blog	blogger, blog, bloggers, blogging
contribute	contributor, contribution
yell	yell, yelling, yelled
promise	promise, pledge, phrase
sit	sitting, sit, seat, seated, sat, student, second
shave	shave, shaving, shaved
adjust	adjustment, adjusted, adjust, adaptation, adjusting, adapt, above, acronym
fuck	fuck, fucking, first
shatter	symbol
Die	doctor, diabetic, dog, depressive
dream	dream, dreaming, delusional
execute	execution, execute, executed, executing
elaborate	elaborate, example
right	regular
out	out, outing
behave	
maybe	member, monk, musician
destroy	destroyer, destroy, destruction, destroyed, destructive
swallow	swallow, swallowing, smoker, student
rain	rain, rainfall, rainy, ra
test	test, term, testing, tested
knock	knock, knocking, knocked, knocks
rally	rally, rt, rallying
regress	regression, regress
prove	physician
buckle	buckle, belt, buck, brace
suit	suit, symbol
hide	hide, hiding
then	term
study	student, scholar, study
swim	swim, swimming, sailor
inherit	inheritance, individual, inherit, inherited, immigrant
reign	ruler
regenerate	regeneration, regenerate, recipient, regener
retweet	retweet, rt
clarify	commissioner
cross	cross, crossing, cyclist, commuter, crossover, crossed
submit	submission, subscriber, submitting, submit
beg	begging, beg, baker, begg, butcher
need	need, needs, needy, needed, name
whine	whine, whining, word
relent	regular
donate	donor, donation
later	latter
exit	exit, employee, exiting
draw	drawing, draw, drew
investigate	investigator, inspector, investigation, insider
click	click, clicked
himself	hobby
beat	beat, boxer, belt, beating
celebrate	celebration, celebrating, celebrate
surprise	surprise, surprised
depart	departure, diver
wake	wake, woke, waking, word
spill	spill, spilled, spilling, spills, skip, splash
soar	superhero, symbol, soaring, soar, superstar
cheat	cheat, cheating
point	point, pointer, person, pointing, pistol, professional, practitioner
open	open, owner, opening, office, operator
cope	coping, cope, condition
wander	wandering, wander, word
probably	phrase, person
begin	baker
repeat	repeat, repetition, routine, regular
kick	kick, kicker, kicking, kicked, kicks, ko
freak	freak, first, fan, former, fre, fanatic
tire	tire, term, tires
enter	enter, entry, entering, employee, entered
forever	first, follower, fan, following
stumble	stumble, stumbling, stagger
translate	translator, translation, translating, translate, translated, tutor, title, term
battle	battle
feel	first, feel, former, feeling
also	alias, atheist, actor
concede	captain, cheat, coach, commissioner, cutter
split	split, separation, splitting
cure	christian
surface	symbol, surface
catch	catch, catcher, catching, caught, catches, cat, cheat
coach	coach, coordinator, coaching
climb	climb, climbing
back	
date	date, dating
register	register, registered, registration, registrar, regular
want	want, word
poop	poop, poo, phrase, person, professional, pet
pause	pause, paused, phrase, pedestrian, pauses
enlist	enlist, enlisted
switch	switch, switching, shift, swap, switched
plead	plead, plea, pleading, phrase, prosecutor, pardon
either	employee, enthusiast, editor
cover	cover, covering, contributor, correspondent
spring	spring, symbol, sprung
hate	hate, hateful, hatred, hating
toast	toast, term, title
race	racer, regular, runner
repent	repent, repentance
experiment	experiment, experimental, eccentric, expert, experimentation, enthusiast
form	form, female, first, forming, formation
kid	
balk	baker, blogger
develop	
merge	merge, merging, meta, merger, merged, member
still	symbol, saint, subscriber, smoker
Fall	following, first, fit, female
score	score, student, scorer, star
inspire	inspiration, inspired, inspirational, inspiring, inspire, inspires
question	question, questioning
feed	farmer, follower, following, first, feed, feeding
clean	cleaner, clean, cleaning
excel	expert, excel, elite, example
snow	snow, symbol, snowy, snowball, shovel
jail	jail, jailed
account	account, accountant, administrator, above, admin, accounts, average, agent
rejoice	rejoice
apologise	apology, apologise, apolog, apologize, apologies, apologised, apologizing, apologized, acronym, above
rebound	rebound, recovery, rm, recovering, relapse
rap	rapper, rap, r
recognize	regular, resident, recognition
err	err, erratic, eccentric, example
roar	roar, roaring
correct	correct, correction, correcting, corrected, comma, comedian
shift	shift, supervisor, server
commit	commit, criminal, committed, cheat, cop
blame	blame, blaming
here	headline
become	
shut	symbol, shut, smoker
recall	recall, recalled, recollection, remember, remembering
trip	term, traveler, trip, tourist, traveller, title
ascend	ascend, ascended, ascent, ascending, attendant, artist, asc, above
rank	rank, ranking, ranked, regular
I	i
wear	woman, wearer
roll	roll, rolling, rolled, roller, rolls, rapper
love	love, lover, letter
nod	nod, nodding, name, nodded, nods
flourish	flourish, founder, first, flourishing
figure	first, figure, following, fan, follower
transform	transformation, transform, transformer, term, transgender, transformed, transforming, transition
died	death, dead, deceased
steal	steal, stole, stealing
launch	launch, launcher, latter, launching
refrain	refrain
flood	flood, flooded, flooding, first, farmer
death	death, deceased, dead
interfere	interference, interfering, intruder, interrupt
bed	bed
attest	athlete, accountant, administrator, artist, atheist, addict, actor, above, acronym
shrug	shrug, symbol, sheep
expand	expansion, employee, entrepreneur, exercise, elephant, eagle
breathe	
float	float, first, following, floating, flyer, fly
cut	cutter, cut, cutting
wink	wink, word, wizard
conform	conform, conservative, conformity
first	first, founder, follower, freshman, friend
star	star, superstar
disperse	disperse, detachment, deviation
ruin	
produce	producer, professional
demonstrate	demonstration, demonstrate, demonstrating
cancel	cancel, cancellation, customer, cancelled, canceled
swing	swing, swinging, symbol, shooter
him	
terminate	termination, term, terminate, terminated, terminating, title, termin
result	regular
dissolve	dissolve, dissolution, dissolved
smell	smell, scent, stink, sniff, smoker
note	note, name, notebook
identify	individual, identifier, identity, identify
bet	bet
preach	preacher, pastor, prophet, priest, phrase
ring	ring, ringing
edit	editor, edit
wish	wish, wishing, wishes, wished, witch, word
despair	depressive, despair, depressed, depression
differ	difference, disagreement, differ, disagree, deviation
like	like, liked
hunt	hunter, hunt, hunted, hunting, hunters
collect	collector, collection, collect, collecting, collectors, curator
set	set, symbol, smoker, setting
spawn	spawn, suffix, spawning, symbol, spawned
cough	cough, coughing, condition, c, comedian
finally	first, following, follower
awake	awake, alert, alarm, acronym, adult, awakened, awakening, above
deploy	deploy, deployment, deployed
push	push, pt, pushing, pushed, press, phrase
instead	individual
glow	glow, gemini, glowing
plan	planner, plan, participant, planning, phrase
dead	dead, deceased, doctor, death
joke	joke, joking
mean	member
bond	bond, bonded, buddy, bonding
forgive	forgiving, forgive, forgiveness, forgiven, friend, first, following
us	user
camp	camp, camping
well	word
Tweet	tweet, twitter, term, title, troll
claim	claimant, claim, claiming, claimed, claims
haunt	haunt, haunting, haunted, hallow
use	user, users, use
only	occasional
resonate	resonance
direct	director, direct, directing
shop	shop, sho, symbol
actually	atheist, actor, artist, acronym, accountant, american, alias
grin	grin, grinning, grinned, gentleman
leap	leap, leaping, latter
focus	focus, focused, following, first, former
state	state, senator
mine	mine, miner, manager, mining, miners
loose	loose, latter, label, loser, leak, lightweight
command	command, commander, colonel, commanding, captain
prison	prison, prisoner, phrase
really	regular, rebel
age	aging, adult, aged, age, ageing, above, acronym
in	in, immigrant, individual, independent, invalid
reveal	regular
cheer	cheer, cheering, champion, competitor
escalate	escalation, escalated, escalate, example
enroll	enrolled, enroll, enrollment, enrol
wreck	wreck, wrecked, wre
provide	provider, professional
witness	witness, witnesses, witnessing, witnessed, watch
print	printer, print, publisher
prosecute	prosecutor, prosecution, prosecute, pc, phrase, practice
touch	touch, term, tactile
overdose	od, overdose, opioid, overd, outpatient, op
blush	blush, bold
will	will, word
send	sender, subscriber, symbol
revert	revert, reverted, reset, reversal, reverse
withdraw	withdrawal, withdraw, withdrawn, withdrawing
carry	carry, carrying, carried, carrier, cyclist
default	default
train	term, trainer, title, train
bend	bend, bent, bending, brace
practice	practitioner, professional, practice, practicing, physician
slay	symbol
whistle	whistle, word, whist
tie	tie, term, tied, tying, title, tailor
failed	failure, failing, fail, failed, former, first
sew	sew, seam, sewing, symbol
ski	ski, symbol, skiing
subscribe	subscriber, subscription, subscribe
awaken	awake, awakening, awakened, alert, alarm, awaken, apprentice, acronym, adjective
it	individual
dare	dare, daring, dared
already	alias, already, atheist, acquaintance
slow	slow, slower, smoker, second, speed
debut	debut
tear	tear, term, tearing, torn, tore
shortly	symbol
interrupt	interrupt, interruption, interrupted, interrupts, intruder
clash	clash, conflict
deal	dealer, deal
nurse	nurse, np, name, nursing, nurses
fragment	first, follower
better	
build	builder, build, builders
child	
one	
soften	saint, symbol
fast	fast, fasting, first, following, follower, faster, former
attempt	attempt, amateur, athlete, above, addict, attempted, artist, acronym
punch	punch, punching, phrase, punched
power	power, prefix
overcome	overcoming, obstacle
sweep	sweep, sweeping, sweeps, swept, scrub
book	book
respawn	respawn
curse	curse, cursed, cursing, curses
charge	customer, charge, clerk
rip	rip, ripped, ripping
relate	relationship, regular
disarm	disarm, designation
whisper	whisper, whispering, word, whispered, witch, writer
let	latter, letter, let
transfer	transfer, term, trader, transition
increase	increase, individual
gain	gain
chuckle	chuckle, comedian, comedy, chuckled
swell	swell, swelling, suffix, symbol, swollen, steroid
multiply	multiply, multiplier, multiplication, mathematician, mushroom, monarch
pump	pump, phrase, pumping, professional, practitioner
murder	murderer, murder, murdering
morph	morph, mutant, man, mole
part	participant, partner, part
update	update, user
left	leave, latter, leaving, last, letter
double	double, doubling, definition, dual
combust	combust, combustion
fracture	fracture, fractured, fracturing, first, former, form
retreat	retreat
realize	regular
dry	dry, drying, dried, definition
wave	wave, waving
spoil	spoil, symbol, spoiled, saint
sweat	sweat, sweating, sweaty
relax	relaxed, relax, relaxation, relaxing
text	text, term, texting
bear	bear, bearing, bore, boxer, bull, baby
reconcile	reconciliation
swarm	swarm, suffix, symbol
collaborate	collaborator, collaboration, collaborative
reverse	regular, runner
cost	customer, consumer, cutter
block	block, blocker, blocked, blocking, blocks, blockers, blank
black	black
thank	thank, thanking, thankful, term, title
declare	declaration, declare, declared, declaring, designation, doctor, disclaimer
own	owner, ownership, owned
experience	enthusiast, experienced, experience
adopt	adopt, adoption, adopted, adopting, adoptive, adop, above, applicant, acronym
advance	advance, advanced, athlete, academic, advancing, above, amateur, ace, a, acronym
complete	completion, complete
descend	descend, descent, descending
function	function, functioning, functional, first, former, following, form
step	step, stepping, symbol, scale, second
announce	announcer, announce, announcement, announcing, athlete, acronym, announced, administrator, above
reload	reload, regular
add	add, addition, accountant, adding, above, added, addict, average, acronym
skate	skate, symbol, student
spike	spike, spiked, symbol, second, surge
resolve	runner, regular
up	up, user
assist	assist, assistant, assisting, administrator, auxiliary, attendant, aide, admin, above, acronym
boy	blogger
dies	death, dying, dead, deceased
chill	chill, comedian, casual
search	search, seo, sear, searching, seeker
offer	offer, offering, officer, offers, offered
measure	measure, metric, measurement
spit	spit, spitting, smoker, spat, sponge
profit	profit, producer, professional, phrase
bow	bow, bowl, belt
eject	eject, ejected, employee, ex, empty, exception
shed	shed, shedding, symbol, smoker
bust	bust, busted, boxer, bum, buster
jam	jam
corrupt	corrupt, corruption, cheat, criminal
wipe	wipe, wiping, wiped, worker, word, wipes
cringe	cringe, comedian, chuckle, clown
sigh	sigh, sighed
veto	veto, vetoed, vote, voter
scar	scar, symbol, surgeon
plummet	phrase
cycle	cycle, cyclist, commuter
scatter	scatter, scattering, symbol, suffix, squirrel, scattered, sprinkle
wrestle	wrestler, wrestle
indict	insider, individual
hurry	hurry, hurried
disapprove	disapproval, disapprove, dislike
game	gamer, game, gm, gp
fart	fart, fan, first
hire	hire
compensate	chef
assume	accountant, athlete, atheist, artist, adjective, above, actor, actress
signal	signal, symbol, sign, sos, signaling
sacrifice	sacrifice, soldier, sacrificing, saint, symbol
suspect	suspect, second, suspected
prepare	planner, professional, prepared, preparation
stir	stir, stirring, symbol, smoker, second
relocate	relocation, relocate, resident, relocated
roast	roast, roasted, royal
lapse	lapse, latter
free	first, following
somehow	symbol, saint
topple	term, title
tour	tour, title, term, touring
offend	offended, offensive, offender, offend, offense
sail	sailor, sail, sailing, symbol
hatch	hatch, hatched
rant	rant, r, racist, rage
fish	fisher, fisherman, fish, following, first, fishing, fishermen
proceed	physician, professional, practitioner
dig	dig, digging, dug, diver, drill
crater	crater
wash	wash, washing, word, woman
light	light, latter, lighter, letter
shit	shit, slut, squat
throw	throw, term, throwing, thrown, threw, toss, throws
boom	boom, buff, bust, banker, bo, bum
upload	upload, user
reform	
divine	divine, deity
mend	musician, monk
satisfy	
predict	predictor, prediction, psychic, predict, psychologist, planner
myself	member
convict	convict, commissioner, clerk, criminal
litter	litter, latter, letter, littered
progress	progression, progress, practitioner
RIP	regular
more	member
discover	designer
boot	boot, boots, booted, boxer
design	designer, design, designers, designation
divide	divide, deviation, division
herself	
police	policeman, police, pd, professional, phrase
vent	vent
okay	owl, ocd
rupture	rupture, rupt
rage	rage, raging, racist
capture	capture, capturing, catcher
shudder	shudder, shake, shaking, sleeper, sham
reach	regular, reader, reach
fix	fix, following, fixed, first
bless	blessing, bless, blessed, bishop
box	box, boxer, boxing, buff
handle	handle, handler
conquer	champion, conquer, conquest
after	atheist, athlete, accountant, alcoholic, addict, artist, actor, adjective, acronym
court	court, clerk
control	control, controlling, controlled
shove	shove, shoved, snowball
likely	latter, last
rape	rapist, rape, r, raping, raped
stall	stall, symbol, stalls, seller, st
list	list, listing, latter, last
if	individual
hail	hail, ha
scale	scale, symbol
paint	painter, professional, painting, paint, practitioner, pro
lay	lay, laying, latter
balloon	balloon, bubble, boom
unravel	user
mate	mate, match, mating
fill	fill, first, following, filling
rent	rental, rent, roommate, resident
vary	volunteer
enjoy	enjoyment, enthusiast, enjoy, employee
fine	following, first
doubt	doctor, depressive
cop	cop, cp
referee	referee, ref, referees
betray	betrayal, betrayed, betray
host	host, hosting
scan	scan, scanner, scanning, scanned, subscriber, symbol
embrace	embrace, embracing, embraced, ex, enthusiast
home	home, homeowner, household, house
protect	protector, protection, protect, protected
overlap	overlap, overlapping, observer
dawn	dog, doctor
good	
Win	
decay	decay, delinquent
that	term, title
reboot	reboot, reset, restart, reborn, rebirth
boast	boast, bully, bragging, boasting
crawl	crawl, crawling, creep, crawled, craw, crow
man	monk, man
receive	recipient, reader, receiving, receiver, regular
conclude	
resume	resume, regular
put	phrase
blind	blind, blinded, blindness, blinding, beginner
resurrect	resurrection, resurrect, reborn, resurrected, rebirth, revived, revival, revive
flow	flow, first, follower, following
farm	farmer, farm, following, first, farmers, farming
defend	defender, defend
all	athlete, atheist, average, actor, accountant
trump	trump, term, title, trumpet
her	
he	
reproduce	reproduction
riot	riot, r, racist
press	press, phrase, pr, photographer
skyrocket	symbol
breed	breed, breeding
echo	employee, editor
so	saint, symbol
photograph	photographer, professional, photographic, photograph, phrase, pro
face	face, first
recoil	recoil, rebel
bowl	bowl, belt
arrest	arrest, arrested, arresting, above, activist, acronym
stare	stare, staring, stared
unite	unity, union, united
trust	trust, trusting, trustworthy, trusted, term
drift	drift, drifting, drifted, diver, dj
tread	tread, term, title, trail
gasp	gasp, gag, gasped
spell	spell, spelling, suffix, scholar, spelled
beam	beam
beware	buddhist
mobilize	mobilization, mobilized, mobilize, mobil
no	name, noun, no, nobody
bring	
curl	curl, curled, condition, curly
fuse	fuse, fusion, first, female, fit
wins	winner, win
scoff	scoff
cum	cum, condom
clear	clean, cleaner, clear, condition, clearing, certification
trigger	trigger, term, triggering, triggered, triggers, target
hike	hike, hiking
hell	hell
chip	chip
verify	verified, verification, verify, verifying, volunteer
shake	shake, shaking, shook, shakes, symbol, shaken
once	
reason	rational, reason
twitch	twitch, term, tick
applaud	applaud, applause, athlete, audience, acronym, american, applauded, a
operate	operator, owner, operative
solo	solo, singer, single
self	self
integrate	integration, integrated, immigrant, integrate, individual, integrating
perhaps	phrase, person
teleport	teleport, term, title, teleportation, transporter, traveler, tele, titan
convince	christian
record	record, regular
sound	singer, sound, speaker
upgrade	upgrade, update, upgrading, user
this	term, title
life	latter, letter
baby	baby, baker
shower	shower
wind	wind, word, winding
pack	pack, packed, professional, phrase, packing
however	
tip	tip, tipping, term, title
project	project, programmer, professional, person
anyways	athlete, atheist, accountant, artist, actor, alcoholic, adjective
repay	repayment
sob	sob, singer
reject	reject, rejection, rejects, rejected, rejecting, refusal, rebel
duck	duck, ducks, diver, dove
broadcast	broadcaster, broadcast
delay	delay, delayed, delinquent, delaying
inform	inform
slice	slice, sub
communicate	communication, contact
copy	copy, clone
hand	hand, handed, handing, holder, hands
mature	mature, maturity, millennial, matured
contend	clerk
wed	wed, wife, widow
stray	stray, second
dress	designer, dress
observe	observer, observing, observe, observed, observes, observation
peak	peak, phrase
deny	doctor
compare	comparison, compare, competitor, comparing
storm	storm, shutdown
restore	regular
restart	restart, reboot, regular, reset, replacement, reload
charm	charm
stone	stone, symbol, stones, suffix, skip
code	code, compiler
deflect	deflect, distraction, duck
won	winner, win
tumble	term, tumble, title
feature	following, first, feature, former
appreciate	appreciation, artist, appreci, appreciated, appreciate, above, adjective
time	term, timer, time
fare	fare, first, following
else	employee, editor
dictate	dictate, dictator
cause	comma, cause, creator, contributor
depend	dependent, dependency
what	word
fumble	fumble, following, former, first, footballer
hover	hover, hovering, hawk, helicopter
hug	hug, hugging, hugged, husband
harvest	harvest, harvesting, hunter
piss	piss, plural, prefix, phrase, pee, pissed, pest, poop
abort	abort, abortion, aborted, acronym, abortions
space	symbol
orbit	orbital, orbit, observer, owl
brew	brewer, brew, brewing, bartender, baker, brewery
supply	supplier, supply, seller
rescue	rescue, rescuing, rescued, resc
compute	compute, cpu, computation, computing
on	on
allow	athlete, accountant, alcoholic, atheist, artist, addict, administrator, above, acronym
frown	frown, face, first, frowned
rewrite	rewrite, rewriting, reviewer
engage	engaged, engagement, enthusiast, engage
divorce	divorce, divorced, div, definition
defeat	defeat, defeated
fear	fear, fearful, first, fanatic
often	often, ordinary, occasional
impress	impress
yes	
OK	ocd
name	name, named, nickname, naming
delete	delete, deletion, deleting, deleted
strip	strip, stripping, slut
both	bisexual
boil	boil, boiler, boiled, boiling, baker
lift	lift, lifting, latter, lifted
moan	moan, moaning
summarize	student
weld	weld, welding, word, worker
challenge	challenge, challenger, challenged, competitor, challenging, champion, coach
review	reviewer, review, reader, reviewers, regular, reviewing
pretend	pretend, pretending, phrase
down	down, depressive, diet, dip, dog
achieve	athlete, achieve, a, average, above, academic, acronym
request	request, requesting, requested, regular
long	long, latter, longevity, lifetime
thing	term, trainer
succeeded	success, successful, scientist, specialist
rush	rush, rushed, rushing
flock	flock, farmer, follower, following, first, flyer
homer	homer, hitter, hr, hammer
by	
weigh	weight, weigh, word
defect	defect, designation
party	party, professional, promoter, pro
distract	distraction, distracted, distract, distracting, diver
cool	cool, cooler, citizen, casual
recruit	recruit, recruiting, recru, recruitment
sniff	sniff, smoker
align	alignment, athlete, aligned, align, asteroid, astronaut, average, above, acronym
immediately	individual, immediate
fret	fret, first, former, freak
empty	employee, empty, elephant
transition	transition, term, transitioning, transgender, transitioned, transsexual, transitional, trans
infect	infected, infect, infection, individual, infectious
day	day, daily
itch	itch, itching, irritated, individual, irritating, iasis
forfeit	forfeit, following, forfeiture, former
sense	sense, symbol, second
evacuate	evacuation, evac, evacuated, evacuate, escape, emergency
top	top, term, topping, title
them	term, title
demand	doctor
pretty	person, phrase, professional
cap	cap, citizen, captain
abide	adherent, accountant, administrator, above
girl	
nest	nest, name, nesting
commute	commuter, commute, cyclist, commuting
key	key, keyboard
BE	blogger
patrol	patrol, policeman
create	creator, creative
hopefully	
shock	shock, shocked, shocking
seem	
present	participant, person, presenter, professional, presence, plural
capitalize	capitalize, comedian, comma
file	filing, first, file, former, following
guard	guard, guardian
am	am, amateur, atheist, adjective, above, artist, acronym
solve	solve, solved, solution, solving, symbol, success
just	jerk
we	
head	head
breakdown	breakdown, breakup, bipolar, borderline
drip	drip, drop, diabetic, dripping, doctor
off	
discriminate	discriminate, discriminating, discriminatory, discrimination
accelerate	acronym, acceleration, accelerate, accelerator, athlete, accelerated, accelerating, ace, adjective
chew	chew, chewing
invest	investor, individual, insider, investment
bullshit	bullshit, bull, bitch
spend	second
spin	spin, spinning, spun, suffix, spins
flash	flash, first, flashing, fan, following, flashed
God	god
mount	mount, member, mountain
snowball	snowball, symbol, snow, snail, shovel
jog	jog
compromise	compromise, commissioner, cheat, chef
alone	alone, artist, anarchist, alcoholic, acronym
Fail	first, following, former
retract	retract, retracted
collide	collision, crash, crossover, collide, concussion, cyclist
foul	foul, fou, following, fan
freelance	freelance, freel, following, first, former
wolf	wolf, word, werewolf
guarantee	
repeal	regular, runner
misunderstand	misunderstanding, misunderstand, mistake, misunderstood, mistaken, misconception
taste	term, taste
address	address, alias, acronym, addresses, american, accountant, am
sway	sway, symbol, shake, swing
repair	repair
wrong	word
campaign	candidate, campaign, congressman
to	term, to, title
anchor	anchor, athlete, affiliate, announcer, anchors, actor, above, amateur, article
venture	venture
definitely	dog
renew	renewal, renew, renewed, regular
download	download
even	even
derail	derail, derailed, designation, driver, deviation
vacuum	vacuum, vac
answers	answer, administrator, a, admin, above, acronym
contract	contract, contractor, client
phone	phone, phrase, person
rethink	runner
unfold	user
bike	bike, bicycle
chat	chat
steer	steer, symbol, sheep
coin	coin
recharge	recharge, runner
two	term, title
abound	accountant, athlete, atheist, artist, addict, alcoholic, actor
manifest	manifest, manifestation, manifested
worsen	word
piece	phrase, piece, pt
school	school, student, schooling
reopen	regular
enough	employee, exercise
Posted	phrase
DJ	dj, dm
migrate	migrant, migration, migrate, migrating
way	word
torture	term, torture, tortured, terrorist, title, tort, tyrant
invite	invite, invitation, inviting, invited, invites, initiate, individual
crest	cyclist
define	dog
WIN	
disband	drummer, disband
surely	symbol
survived	survivor, survival, soldier, survive, species
license	license, licensee, licensed, latter, llc, licence
there	term, title
year	year
pale	pale, paleo, person
OD	od, overdose, op, o, opioid
advise	adviser, advisor, advise, agent, advocate, advisory, accountant, above, acronym
Survive	symbol
consider	consider
type	term, type
separate	separation, split, separate, separating, separated, suffix, single, second
skip	skip, skipping, skipped
drag	drag
spot	spot, symbol, second, sighting, spotting
sunset	sunset, sailor, symbol, second
most	member
reside	resident, residence, residency
expect	employee, expectation, expect
college	college, collegiate
order	order, ordering, owner, orderly, ordered
lock	lock, locked, locking, locker, latter, label, lockdown, locks
rear	rear, rider, racer, r
quote	quote, quotation
interview	interviewer, interview, intern
away	accountant, absence, artist, amateur, athlete, away, american, above
son	symbol
bald	bald, buff, blonde, bob, beard
might	member, monk
stitch	stitch, stitching, symbol, stitches, subscriber
stump	stump, symbol, smoker, skip
course	
over	over, overweight, obese
Cry	
she	symbol, she, surname
grace	grace, guest
swoop	symbol
support	supporter, support, sponsor, second
lecture	lecturer, lecture, latter
debate	debate, debating
reap	reap
themselves	term, transgender
stew	stew, symbol, stewart
trade	trader, term, trade, title
known	
dot	dot, doodle
malfunction	malfunction
lack	lack, latter, loser, lazy
avail	athlete, above, addict, accountant, acronym, active
yawn	yawn
consent	consent, consensual, condom
brawl	brawl, boxer, bum, berserker, bully
reflect	reflection, reflect, reflecting, reflective
pursue	professional, pro, phrase
proof	proof, professional, person, phrase
speed	speed, speeding, symbol, speedy
place	person, place, prefix, practitioner
sketch	sketch, symbol
quickly	
plot	plot, planner, phrase, programmer, plural, plotting
trick	trick, term, thief
invade	intruder, invasion, invading, invade, invaded, invaders
gamble	gamble, gamer, gambling
determine	doctor, diabetic, dog
coast	cyclist, captain, commuter
latch	latch, label, latter
gel	gel
stroke	stroke, strokes
opt	opt, option, owl
brain	brain, buddhist
eclipse	eclipse, eclips, enthusiast
sour	sour, smoker
badly	baker
perfect	
loot	loot, looting, looted, latter
mix	mix, mate
shovel	shovel
parent	parent, professional, principal
elect	elect, elector, elected, election
zero	
rocket	runner
filibuster	filibuster, following, first
shred	shred, shredded, symbol, staple, scissors
expose	expose, exposing, exposure, exposed, escort, employee
reconnect	reconnect, relationship, reunion
nail	nail, name, nails
s	s, saint, sub
ignite	ignite, ignited, incendiary, individual, ignition
mail	mail, mailbox, mailing
dispute	dispute, disagreement, disputed, disagree, disturbance
circulate	circulation, circulate, contributor, collector
dust	dust
size	size, symbol, scale
mushroom	mushroom, mushrooms
dwell	dwelling
Skype	skype, subscriber
sprint	sprint, superhero
grate	grate
override	owl
white	white, word, woman
fib	fib, fraud, fake, first
mother	mother, mom, mum, mp, m
crow	crow, cowboy, cobra
weather	word, weather
harm	harm, harming
reward	reward, rewarding, rewards
a	atheist, athlete, actor, artist, average, alias, acronym, adjective
spew	spew, spokesperson
revive	revive, regular, revived, revival
replace	regular
punt	punt, pat, position, pun, phrase, player, pt
blast	blast, blasting, bomber
Live	latter
scroll	scroll, symbol, scrolling, suffix
provoke	provocation, provoke, psychopath
represent	representative, representation, represent
slam	slam, slams, slamming, smash, slammed, student
alert	alert, alarm, acronym, alerts, above, active, adherent
email	email, e, editor
red	red, redd, runner
stack	stack, stacking, stacked, stacks
spar	spar, student
fulfill	following, first, follower, form
desert	desert, deserted
pin	pin, pins, pinned, pinterest, person
father	father, following, first, female
track	tracker, term, track, title, trainer, tracking
job	job
ensure	employee, editor, exercise
innovate	inventor, innovation, innov, innovative, individual, innovate
late	late, latter, letter
flag	flag, first, following, flags
sober	sober, smoker
zip	zip, zipper
fuel	fuel, following, fleet, former, first
heat	heat, heater, hot
acknowledge	administrator, artist, acquaintance, accountant, acknowledge, above, acknowledgement, admin, acronym
troll	troll, term, trolling, title, trolls
heart	heart, hobby
gather	gathering, group, gather
negotiate	negotiator, negotiation, name
gold	
maintain	member, minimalist, monk
tattoo	tattoo, term, title, tatt
revise	revision, revise, reviewer
brake	brake, braking, brakes
activate	activate, activation, administrator, active, admin, activated, alpha, above
parachute	parachute, pilot, phrase, professional
second	symbol
lost	loss, lost, loser, latter, losing, lose, letter
sample	sample, scientist, sampling, student
ultimately	user
surf	surf, surfing, symbol
sometimes	
exercise	exercise, enthusiast, exercising, elite
easily	expert, enthusiast, eccentric
honor	honor, honorary, honoring, honour, honored, honorable, honors
Sunday	symbol
include	individual
tackle	tackle, term, title, tackling
cruise	cruise, captain, cruising, cru
sir	symbol
single	single, singles, split
at	acronym, at, atheist, attending, alcoholic, athlete
Be	
ID	id, identification, ids, individual, identity
ready	regular, runner
blank	blank, blogger, blog
redirect	regular
yellow	yellow
none	name
earn	employee, entrepreneur, earning, earn, earned, example
illustrate	illustration, illustrating, illustrated, illustrate
recommend	regular, recommendation
inevitably	individual
converge	
dive	diver, dive, dove, divers, diving
wit	word, woman
soul	symbol
rake	rake, rider, roller
sag	sag
approach	acquaintance, approach, assistant, agent, associate, advisor, applicant, above
influence	influence, individual, influential
Miss	musician
park	park, parking, parked
trace	trace, term, tracker, tracing
ha	ha
await	accountant, atheist, actor, administrator, athlete, artist, acronym, adjective
jar	jar
gone	gym
document	document, director
grab	grab
partake	participant, patron, person, plural
disconnect	disconnect, disconnected, diver
literally	
flirt	flirt, first, friend, following, fan, former, follower
surpass	second
guide	guide, guiding, guides
Wed	wife, word
delegate	delegate, delegation, delegated, director, deputy
deserve	dog, deserving, disability
commence	
Google	google
entertain	entertain, entertaining, entertainment
wanna	wanna
cast	cast, casting, caster, character
accomplish	athlete, accountant, average, artist, amateur, above, acronym
persuade	persuade, preacher, psychologist, plural, phrase
chant	chant, chanting
govern	governor, government
diminish	dog, doctor, depressive
unveil	
bottle	bottle, bartender
interpret	interpreter, interpret, interpretation, interpreting, interpreted
sustain	soldier
draft	draft
educate	educator, education, educated, educate
counter	counter, cheat
bind	bind, binding, bound, binds
warn	warn, warning, word, warned, watch
narrow	name, noun
explore	explorer, enthusiast, exploration, entrepreneur
calculate	calculator, calculate, calculation
premiere	producer, premiere, performer, pro, presenter, pilot, prefix
seize	symbol, smoker
flame	flame, flaming, fan, fire, fireball, first
drone	drone, drones, dj
bat	bat, batter
recite	recite
sooner	symbol
fruit	fruit, following, first, farmer
night	night, name
bluff	bluff, buff, blank, bully, bum
bob	baker, bob, bee, boxer
gag	gag, goblin, goat, g, gorilla
war	war, warrior, word
hint	hint, habit
tick	tick, term, ticks, ticking
creep	creep, creepy
detect	detector, detect, detecting, designation, detection
consume	consumer
amend	amend, accountant, admin, administrator, alter, assistant, above, acronym, adjective
disclose	disclosure, disclosing, disclosed, disclose, disclaimer
detail	detail
bother	bother
stress	stressed, stress, stressing, stressful, student
LIVE	live, latter, living
flush	flush, flushed, first, fan
dim	dog, depressive, doctor
conflict	conflict, clash
rat	rat, rats, rodent
lol	latter
imagine	imaginary, imagination, individual, imagine
organize	organizer, organization, organized, orderly, official, organizing
bid	bidder, bid, buyer
ghost	ghost, ghosts
cancer	cancer, condition, colon
ice	ice, icy, individual, icing
Blink	blogger
rescind	regular
recycle	recycle, recycling, recycled, regular, reuse
erase	erase, erased, edit, editor
permanently	prefix, person
brother	blogger
avoid	avoidance, avoid, avoiding, addict, above, alien
bill	bill
dock	dock, docking, diver
remove	
NOT	name
sort	sort, sorting, sorted, saint
suicide	suicide, suicidal, suicides
roam	roaming, roam, rat
concentrate	
Saturday	symbol
bankrupt	bankrupt, bankruptcy, billionaire, borrower
climax	climax, condom
yesterday	
knit	knit, knitting
stabilize	
coincide	
load	load, loader, latter, loading, label
labor	labor, latter, labour
soldier	soldier, sergeant
conceive	couple, condition
truth	term
trumpet	trumpet, term, title, trump
contest	contest, competitor, contestant, champion, challenger
purge	purge, pur
Pass	person
ya	
cake	cake, cakes, chef
revenge	revenge
screw	screw, slut
bump	bump, buff, bumped
absorb	absorption, absorbing, athlete, absorb, academic, adjective, artist
upset	upset, unhappy, unstable, upsetting
truck	truck, term, title, tanker
spare	
aid	aid, assist, aide, assistant, auxiliary, assisting, acronym, above
reset	reset, replacement, reboot
warm	warm, warmer, word, warmth
raise	raise
worship	word
rather	regular
stalk	stalk, stalking, symbol
spiral	spiral
lives	living, latter, letter
fal	first, following, follower
decipher	doctor
criticize	critic, criticism, critical, critique, critics, criticizing, criticize
defer	defer, deferred, d
disembark	diver
thin	thin, term, thinner, trim, thick
color	color, colored
salute	salute, soldier, symbol, sergeant
ad	ad, artist, athlete, addict, advertisement, advert, attendant, alias, above, acronym
shot	shooter, sniper, shot, shooting
retrieve	retrieve, retrieving, retrieval
don	diet, dog
fat	fat, fatty, following, former
flower	flower, fan
delight	delight
frost	frost, first, freezer, freeze, farmer, fairy
weaken	weak, wrestler, word, weakening, weakness, weakened
slot	symbol
juice	juice
boycott	boycott, boycot, blockade, bds
grave	grave
sneak	sneak, stealth, steal, sneaking, suspect, symbol
twist	term, twist
STOP	symbol, smoker
waiver	waiver, wrestler
scrape	scrape, scraping, scrub, symbol, sweep, skip
another	athlete, accountant, acquaintance, atheist, american, addict, acronym
best	
some	symbol
otherwise	ordinary, observer
intercept	intercept, interception, intercepted, insider
quake	quake
spy	spy, spying
sub	sub, subs, substitute
specialize	specialist, specialization, specialty, suffix
why	word
surge	symbol
Sue	symbol
breach	breach, breached, break
welcome	welcome, welcoming, word
impact	impact, individual
three	term, title
smack	smack, slap
re	re, regular, resident, runner
scoop	scoop, scout
done	doctor
something	symbol, second
cold	cold
consult	consultant, consult
peel	peel, peeled, pro, professional, producer, peach
trial	trial, term, title
grunt	grunt, grun, goat, gr, grind
dope	dope, dealer, dea
RT	rt, r, rd, retweet, rp, ra, regular
slap	slap, smack, slapping, slapped
nothing	name
final	following, first, follower
require	
prey	prey, phrase, predator, prostitute, pirate
alter	alter, alters, alteration, altered, alternate, artist, above
chose	customer
lag	lag, latter
journey	
film	filmmaker, first, following, fan, film, former
because	blogger
tend	term, tend, type
force	force, first, female, former
worse	word
mark	mark, marking, marker, marked, maker, marks
ly	latter
parole	parole, pistol, pilot, probation
neither	name
chase	chase, cat, chasing, chased
boo	boo, bully, bum
insult	insult, insulting, insulted, idiot, insults
implant	implant, implants, implanted, individual
kids	kid
aim	aim, arrow, athlete, aiming, amateur, artist, above, acronym
research	researcher, research
mesh	mesh, member, mate
smear	smear, sham, slut, slate
root	root, rooted, rooting
probe	probe, phrase
children	child
glory	
somewhere	symbol
thrill	thrill, term, title
mistake	mistake, mistakes, miss
branch	branch, banker, branching, bank, branches
tower	tower, term, title
triple	term, title
sin	sin, saint, slave, second
response	regular, rt, response
family	first, family, farmer, following
radio	radio
co	co, comedian
clot	clot, condition
embarrass	embarrass, embarrassment, embarrassing, embarrassed
select	symbol, selector, subscriber, student
orgasm	orgasm, org
success	success, successful, star
affect	athlete, artist, addict, adjective, affect, accountant
suggest	symbol
when	word
prefer	prefix, plural, person
thunder	thunder, term, title
heel	heel, heels, horse
lament	lament, latter
w	woman, word, wife
but	blogger
wheel	wheel, wheels
mention	member
instruct	instructor, instruct
passed	passing, pass, person, pedestrian, passer
tank	tank, term, tanker, title, trainer
bad	
victory	
discuss	discussion
company	company, corporate, ceo
overthrow	
did	do
heed	
substitute	substitute, sub, substitution
dice	dice, dealer, dwarf
claw	claw, crow
hum	hum, humming, human
heaven	
each	employee, enthusiast, editor
breast	breast, breastfeeding, breasts
Maybe	musician
penetrate	penetration, penetrating, penetrated, piercing, penetrate, plural, penet
exceed	exercise, employee, enthusiast, eccentric
intensify	individual
wax	wax, word, woman
bubble	bubble, boom, burst, balloon, blogger, blog
transcend	term, transcend
shoulder	shoulder, skip
strut	strut, symbol
twins	twin, term, twins, title, transgender, transsexual
factor	first, following, follower, former, fan
silence	smoker, symbol, silence, singer
comfort	
obviously	occasional
speculate	speculative, speculation, scientist, speculate
tweak	term, trainer, trader
advocate	advocate, activist, attorney, advocacy, advisor, ally, advocates, acronym, above
pose	pose, professional, posing, pro, photographer, posed, painter
rate	regular, r, rd, reviewer, rating, rate
thanks	thankful, thanks, thank, thanking, term
blaze	blaze, burn
knows	
buck	buck, bull, bum
describe	dog
snack	snack
fork	fork, first
spark	spark, starter, symbol, star, sparkle, smoker
specify	symbol
parse	
fake	fake, fraud, fraudulent, first, faux, former, following
pour	pour, pouring, poured, phrase, plural, pint, pitcher
glare	glare, glaring, glared
itself	individual
price	price, phrase
mom	mom, mother, mum, mp, m, mama, moms
Monday	musician
chance	cyclist
Tony	term, title
export	export, exporting, entrepreneur, exports, exported
realise	regular
unlock	unlock, unlocked, user, update, unlocking
plug	plug, plugged, phrase, pro, plugs
stretch	stretch, stretching, stretched
personally	person, personal, professional
nonetheless	name, noun
tel	term
reckon	runner
week	week, weekly, weekday
disrupt	disruption, disrupt, disruptive, disrupting, disrupted, disturbance, disorder
administer	administrator, admin, accountant, administer, administration, acronym, assistant, above
smash	smash, smashing, smashed
person	person
enlarge	employee, exercise, enthusiast
before	buddhist
simmer	smoker, symbol, simmer, substitute
Friday	first, following, follower
presume	person
remains	resident, regular
adhere	adherent, adherence, athlete, administrator, above
prize	prize, phrase, professional, pro
sheep	sheep, shepherd, sow
KO	ko
distort	distortion, dishonest, distort
pardon	pardon, pard, phrase, president, patriot
prioritize	priority, prioritize, planner, professional
el	elf, employee
assemble	assembly, acronym
seed	seed, sow, seeded, species, starter
threaten	threat, term, threatening, threatened, terrorist, threaten, title, threats
anymore	athlete, actor, artist, atheist, accountant, actress, administrator, acronym
suppose	symbol
scout	scout, scouting, scouts, second, seal
people	person, people
dad	dog, doctor, diabetic
crush	crush, crushing, crushed
crown	
through	term, title
intersect	individual, intersect, intersection, irregular
runaway	runaway, rebel, runner
spear	spear, symbol, soldier, shar
dissent	dissent, dissenting
audition	audition, agent, actor, athlete, above, applicant, actress, artist, amateur, a
stream	stream, subscriber, symbol
shutter	shutter, symbol, shooter, shoot
wee	wee, word
hitch	hitch, helper
rust	rust, rusty
seat	seat, server
bottom	bottom, beginner, below
flare	flare, flared, flares, first, fan, fever
weave	weave, weaving, word, witch, woven, woman
spray	spray, spraying, sprayed, shooter, sniper
revel	revel
stain	stain, student, stained, scrub
big	
apprentice	apprentice, apprentices, above, associate, assistant, affiliate
U	user
invent	inventor, invent, invention, innovation
moon	moon, moons
remake	regular
iron	iron
brood	baker, bee, bird
zoom	zoom, z
equal	employee, equal
wrap	wrap, wrapping, wrapper, wraps
Earth	elf, enthusiast
ease	employee
boys	boxer
assassinate	assassin, assassination, assassinated, assassinate, alias, assassins, agent, acronym
apparently	above, alias, atheist, a, actor
condemn	christian, critic
couple	couple
barbecue	barbecue, bbq, butcher, becue, buff
March	monk, musician, member
milk	milk, mother
encounter	encounter, employee, enthusiast
summon	summon, summoning, summons, symbol, summoner, summoned
blitz	blitz, boss, boxer
al	athlete, accountant, atheist, artist, actor, alcoholic, administrator, acronym
seek	seeker, search, seeking, seek
Rock	runner, regular
flap	flap, first, flyer, fly, fan
stuff	
for	first, following, follower
whatever	
fuss	fuss, first, fan, following, fluffy
effect	employee, exercise
duel	duel
short	short, substitute, subscriber
strive	student, strive
occupy	occupation, occupant, occupy, occupying, occupied, owner
slaughter	slaughter, symbol, sheep
rub	rub, rubbing
bar	bar, bartender, bars
redeem	redeem, redeemed, redemption, regular, repeat
plea	phrase, plea, petitioner
dodge	dog, drummer
plant	plant, planting, perennial
DO	do, doctor
crop	crop, cropped, crow
since	symbol
obsess	obsessive, ocd, obsessed, obsession, obsess
exhibit	exhibit, exhibiting, exhibition, exhibited, example, enthusiast
trans	trans, transgender, transsexual, term, transition, title
revisit	retrospective, resident, regular
flesh	first, female, following
hedge	hedge, hed, hawk
house	house, homeowner, household
refill	refill, regular, ref
install	installer, install, installation, installed
snake	snake, symbol, smoker, snail
minister	minister, mp, ministry, ministerial, mla
remind	regular
percent	
human	human
ignore	idiot, invalid, ignore, inactive, ignoring
kind	kind, kindness, kindly
fell	fall, falling, fell, fallen, first, form
alright	athlete, accountant, actor, atheist, artist, administrator, acronym
calm	calm
usually	user
retake	runner, regular
justice	
filter	filter, filtering, filters, filtered, first, following, fan
brown	brown, black, buff, blonde
analyze	analyst, accountant, analytical, analysis, analyze, analy, analytic, above, adjective
quarrel	quarrel
treat	term, treat, trainer
interact	individual
accidentally	accident, accidental, accidentally, acronym, amateur, a, author
birth	birth, baby
scratch	scratch, scratching, symbol, scratched
aspire	athlete, amateur, aspiring, artist, aspire, above, accountant, aspiration, apprentice, adjective
Wrestle	wrestler
or	
comeback	
trespass	trespass, term, tresp, thief, transient
sack	sack, slack, sacked, sub
retain	runner, regular
issue	issue, individual, issuer
vacation	vacation
grasp	grasp, grip, grasping, grapple
recap	recap, runner, regular
plunge	plunge, phrase
butt	butt, bum, bust, buff, buttocks
mold	mold, mould, model, moth, medium
ash	ash, athlete, above, ashes
great	
grade	grade, grad, graduate, grading, gpa
label	label, latter, labeling, list
master	master, masters, mastery, monk
certainly	comedian
link	link, linking, linked, latter
credit	credit, creditor, consumer, customer
dose	dose, doctor, diabetic
attract	attract, attraction, attractive, attracted, attracting, adjective, a, above
jet	jet
Jack	
tag	tag, tagging, term, tagged, title, tracker
fool	fool, first, following, follower
rotate	rotation, rotate, rotating, rotated, regular
mislead	mislead, misleading
uphold	
pit	pit, phrase, pilot
Read	reader, read, regular, runner
egg	egg, eggs, embryo, easter
naturally	name, noun, natural, naturally
degrade	degrade, degraded
pulse	pulse, practitioner, prefix, pat, patient, pulses
tap	tap, tapping, term, tapped, title
number	number
deter	dog, doctor
action	athlete, active, action, actor, accountant, ant, above, acronym
ramp	ramp, ramps, rapper
others	official, ordinary
owe	owed, owe, owing, owner
completely	christian, complete
exactly	employee, enthusiast
overturn	
dwarf	dwarf, doctor
injury	injury, injured, injure, invalid, injuring, irregular
advertise	advertisement, agent, ad, affiliate, artist, advert, agency, acronym, advertising, above
cow	cow, cowboy, calf
breath	breath
pant	pant, phrase, professional, period, pants
gossip	gossip
parade	parade, pride, professional, phrase, procession
purchase	purchaser
differentiate	dog, doctor
bastard	blogger
pen	pen, pseudonym, printer, poet, pens, pencil
scrap	scrap, scrape, skip, symbol, scra, sweep
combine	combine, combination, chemist
Mars	monk, musician
amount	accountant, athlete, artist, addict, average, administrator, acronym, adjective
grind	grind, grinding, guru
recently	recent, recently, relative
bully	bully, bullying, bullies, bigot, bullied, bull
PR	
bank	bank, banker, borrower
Phoenix	
display	display, designer
November	name, noun
missed	miss, missed, missing, member
inside	insider, individual, intruder
extend	employee, editor, email, elf
moderate	moderate, moderator, moderation, member, moder
moment	monk, meditation, musician, minimalist
swat	swat, symbol, second, sergeant, sweeping, scrub, superhero
whiff	whiff, word
guys	guy, gamer, girlfriend
changed	change
years	
damage	damage, damaged, destroyer, damaging
ban	ban, banning, banned, bans, bartender, boxer
his	
almost	adjective, acronym, atheist, alias, acquaintance, appearance, accident, average, almost
Do	dog, doctor
cater	chef
process	process, practitioner, processing, person, processor
brief	bartender
cluster	cluster, cult, collective, clan
motivate	motivate, motivation, motivated, motiv, manager, motivational
mess	mess, messy, manager
coordinate	coordinator, coordinate, calendar
infiltrate	infiltration, infiltrate, insider, infiltr, infiltrated, intruder, insurgent
deceive	dishonest, deceptive, deceive, deception
LOL	lol, l, latter, laugh, loser, laughing
bang	bang, banging, bm, bum, buff, boyfriend, b
wow	woman
scare	scare, scared, scary
illuminate	individual
amplify	athlete, artist, accountant, administrator, acronym, actor, addict
exchange	exchange, exchanges, exchanged, elf, email, example
overwhelm	owl
of	
pivot	pivot, piv, pilot, phrase
glitch	glitch, gemini, geek
decode	doctor, diver
blend	blend, blending, blended, blender
contact	contact, client
bury	burial, burying, buried, bury
broken	break, broken
monitor	monitor, monitoring, manager
ticket	ticket, term, title, traveler
prick	prick, phrase, painter, period
season	season, seasonal
transplant	transplant, term
GO	gym
food	following, follower, first
is	individual, inactive, irregular, invalid
subpoena	subpoena, second, spokesperson, subpoen
drill	drill, designation, drilling
login	login, log, latter
lap	lap, latter, laps
deepen	diver
shy	shy, shrink
error	error, errors, editor, err
gorge	gorge
Lord	latter
sled	sled, symbol, skeleton, student, snow, ski, sheep
alive	athlete, artist, active, american, adherent, actor, atheist, above, acronym
Not	name
evade	
drain	drain, draining, drains
Jeff	
flight	flight, following, first, flyer
b	b, baker, bi, bee, bartender, brewer
crib	crib, child
trail	trail, term, tracker, title, trainer
cream	cream
squat	squat, symbol, squats
Steve	symbol
ex	ex, escort
ed	employee, exercise
everything	employee, enthusiast
hook	hook, hooked
inquire	individual, inquire, investigator
NEVER	name
comprehend	comprehension, concept
sport	sport, symbol, spectator
slash	slash, slashing, symbol, slashed, savage
promote	promoter, promotion, pr, professional
bag	bag, backpack, bags, belt
least	latter, letter
church	church, christian, congregation, catholic
port	port, passenger, prefix, pirate
attach	attach, attachment, attached, attendant, addict, ap, artist, attaching, athlete
woo	woo, witch, word
swap	swap, swapping, symbol, switch, swapped
blue	
ok	
trouble	term, trouble, tyrant, title
ten	term, title, trainer
endorse	endorsement, endorse, endorsed, endorsing
may	member, mute
grown	gemini
appropriate	athlete, accountant, administrator, actor, artist, atheist, acronym, above
S	s, symbol, smoker, saint, slayer
Rebel	regular
phase	phase, period, plural
throttle	term, throttle, title
loss	loss, lost, losing, latter, label
sip	sip, symbol, student
condition	condition
meltdown	meltdown, mutant
dash	dash, driver
forward	forward, following, first, friend, follower, fan
would	
friend	friend, friendship, first, friends, following, friendly
Greg	
honey	honey
old	old, oldest
rarely	rarely, regular, retrospective
reconstruct	reconstruction
case	case, client
fails	failure, fail, failing, failed, f, former, first
t	term, title, teacher, t, transgender, trainer
few	first, former, follower
early	employee, entrepreneur
sure	symbol
abuse	abuser, abuse, abusive, abused, abusing, abusers, addict, above, acronym
adventure	adventurer, adventure, adventurous, athlete, amateur, above, adjective, acronym
pencil	pencil, phrase, pen, professional, painter
captain	captain, captains, capt, crew, commodore
harass	harass, harassment, harassing, harassed
punk	punk, phrase, pirate
round	round, resident, regular, robin
directly	
compost	compost, citizen
prod	pt
squeeze	squeeze, symbol, squat
farewell	first, following, follower
fray	first, following
everyone	employee, editor
vest	volunteer, vegetarian
hammer	hammer, hammered, hitter
shape	shape, symbol, shaping
failure	failure, following, first, former, follower
dial	dial
Tell	term, title
employ	employee, employed, employer, employ, employment
validate	volunteer, vegan
pro	pro, professional, pt, phrase
within	
chop	chop, chopping, cutter, chopped, cut
grip	grip, grips
journal	journal, journalist
quiz	quiz, quizz, qualifier
team	team, term, teammate
poison	poison, phrase, poisoning, prescription, poisoned
sentence	sentence, speaker
induce	individual, invalid
voice	voice, vocal
amp	amp, athlete, amateur, acronym, amplifier, above, adapter, artist, amps
ret	regular
sick	sick, sickness, smoker
green	green, grass, greenhouse, greens
audit	auditor, audit, accountant, administrator, analyst, acronym, above
ry	r, regular, runner, rider, rat
incite	incite, incendiary, individual, inciting
Go	go, guru, gym, gp
confront	customer, complainant
bleach	bleach, blonde
worm	worm, worms, word, widow
ta	ta, term, title, tap
Rule	runner, regular
haha	
quiet	
crowd	crowd, customer, commuter
lick	lick, licking, latter
inevitable	individual
model	model, modeling, models, modelling
overflow	owl
Pop	person
twice	term, title
counsel	counselor, counsel, clerk, client
treasure	treasure, term, title, thief
album	artist, album, alias, acronym
render	
undo	user
future	first, follower, fan, following
forgotten	follower, first, following
thereafter	term, title
Twitter	twitter, term, tweet, title, tweeting
award	award, administrator, artist, awards, ambassador, athlete, above, acronym
air	airline, air, airplane, astronaut, acronym, aircraft, above, actor, athlete, american
implement	implement, implementation
rig	rig, rigs, ram
instantly	individual, idiot
chain	chain, chains
pine	pine, plural, pagan, prescription
cage	cage, cleaner
warp	warp, word, witch
ferment	ferment, fermentation, fermented, following, farmer
medal	medal, mvp, major
blood	blood
hour	hour
correspond	correspondent, contact
drunk	drunk, drunken, definition, dui, drink
inject	inject, injecting, injection, injected, iv
page	page
amuse	amuse, artist, accountant, attendant, amusement, actor, amateur, actress, adjective, above
scramble	scramble, scrambling, scrambled
revolution	revolution, revolutionary, radical, rebel, revolt
happy	happy, hobby
less	latter, lazy
populate	person, prefix, plural
o	owl
shutdown	shutdown, symbol
limit	latter
pan	pan, phrase, pot, pans, pilot
sand	sand, suffix, sandbox, slate, sandy
er	employee, ex
grant	grant, granting, granted, grants
surgery	surgeon, surgery, surgical
bullet	bullet
kickoff	kicker, kickoff, kick
Know	
jazz	jazz, jam, jack
exhaust	exhaust, engine, enthusiast, employee
widen	word
O	owl
five	first, follower, following
ov	ov, ovarian, o
respect	respect
entirely	employee, enthusiast
publicly	person, phrase, publicly, public
shuttle	shuttle, symbol
transgress	term, thief, transgress
must	must, mechanic
borrow	borrower, borrow, borrowing
tears	tear, term
Rise	runner, regular
recount	recount, recounts, recorder
Christian	christian, convert, christians, catholic, conversion
max	monk, minimalist, member
diet	diet, diabetic, definition
wet	wet, word, waterproof
il	individual
brush	brush, brushing, buff, brushed
and	adjective, atheist, artist, american, actor, acronym, administrator, athlete, alias
pink	pink, pig, purple
reassure	regular, routine
reiterate	regular
streak	streak, symbol
poke	poke
bunk	bunk, bum, bomber, bunker
yourself	
Israel	individual
interest	interest, individual, irregular
limp	limp, latter
class	class
Follow	first, follower, following
app	app, account, administrator, admin, addict, above, applicant
gay	gay
pace	pace, pacing, pr, professional, phrase, pt
recognise	regular, resident, recognition
stock	stock, shareholder, symbol, stocking, seller
should	second, saint
lunch	lunch, latter
things	term
pastor	pastor, preacher, priest, plural
hop	hop, hopping, hopped, hops
soil	soil, suffix, second
quite	
sup	sup, skip, smoker
much	monk, musician, member
correlate	
bites	bite, biting, bitten, bit, bug, bully, beetle
animate	animate, animation, anim, animated, artist, anime, actor, avatar
tan	tan, term
contain	
waste	waste, wasting, wasteful, word
hem	
crew	crew, captain
stagger	stagger, staggered, staggering
Trump	trump, term, title
toss	toss, term, tossing, throw, tossed, throwing, threw, trash, thrown
DC	dog
rampage	rampage, rpg
thought	thinker, term
redesign	
simply	saint
hij	
divest	divest, div, director
reclaim	regular
target	target, term, targeted, targeting
career	
gladly	
happened	
dip	dip, dipping, dipped, depressive, diver, dips, dab