die	kill, harm, injure, hurt, cause, affect, hit, destroy, become, eat
win	defeat, beat, win, overcome, kill, help, overtake, stop, fight, hurt
be	be, become, cause, affect, kill, harm, make, have, create, resemble
survive	kill, save, survive, help, destroy, harm, rescue, defeat, overcome, cure
fail	fail, defeat, succeed, break, beat, help, kill, affect, hit, destroy
succeed	defeat, succeed, help, stop, overcome, beat, assist, kill, fail, aid
live	kill, save, help, become, cause, affect, harm, benefit, live, be
pass	pass, kill, become, affect, be, follow, stop, cause, influence, cross
do	do, cause, affect, kill, influence, help, effect, stop, hurt, harm
cry	hurt, touch, hit, upset, affect, cry, harm, kill, love, comfort
know	know, tell, inform, understand, teach, see, affect, like, influence, help
fall	hit, strike, fall, injure, kill, drop, move, hurt, touch, knock
work	affect, help, do, stop, use, kill, make, cause, work, effect
leave	kill, leave, hurt, harm, attack, hit, injure, follow, affect, destroy
not	kill, be, affect, hurt, harm, become, help, injure, hit, like
come	kill, cause, stop, become, be, follow, affect, help, harm, do
return	kill, return, harm, attack, become, hit, destroy, save, hurt, visit
lose	defeat, beat, lose, injure, win, hurt, hit, help, overcome, overtake
stay	become, kill, leave, stay, be, help, affect, save, replace, follow
bite	bite, hurt, attack, kill, eat, hit, kiss, injure, strike, touch
tell	tell, inform, deceive, hear, teach, warn, mislead, instruct, contradict, know
answer	answer, ask, question, correct, tell, interrupt, reply, prompt, call, understand
try	hurt, kill, help, try, stop, hit, harm, do, attack, injure
explode	explode, hit, kill, hurt, destroy, attack, injure, shoot, harm, affect
disappear	kill, become, be, affect, destroy, harm, replace, cause, hurt, change
go	kill, follow, hurt, hit, cause, harm, move, stop, affect, touch
fly	fly, hit, kill, touch, attack, affect, strike, hurt, influence, cause
happen	kill, affect, be, cause, become, do, harm, hurt, influence, stop
help	help, assist, aid, hurt, save, harm, rescue, kill, benefit, serve
run	hit, attack, kill, hurt, stop, chase, run, strike, harm, kick
respond	hit, provoke, affect, hurt, attack, touch, harm, kill, strike, help
sue	sue, injure, hurt, harm, harass, threaten, hit, attack, kill, libel
change	change, affect, influence, become, be, effect, alter, replace, resemble, cause
remember	remember, remind, recall, forget, teach, affect, recognize, understand, know, tell
last	kill, affect, become, be, save, survive, last, cause, destroy, help
too	kill, hurt, injure, harm, hit, affect, cause, attack, influence, destroy
eat	eat, kill, feed, bite, hurt, affect, harm, consume, help, starve
have	have, affect, possess, be, kill, cause, become, produce, create, get
listen	hear, understand, tell, help, teach, answer, affect, stop, influence, obey
pay	pay, kill, charge, hurt, help, owe, hit, bribe, harm, injure
miss	miss, hit, see, confuse, pass, avoid, catch, delay, lose, follow
understand	understand, teach, help, confuse, correct, know, comprehend, influence, see, affect
retire	retire, replace, kill, become, hire, injure, affect, overtake, be, marry
suffer	injure, harm, hurt, kill, affect, help, cause, suffer, attack, offend
see	see, perceive, touch, affect, cause, notice, deceive, influence, tell, observe
talk	talk, hear, tell, affect, interrupt, speak, stop, call, say, understand
recover	heal, cure, help, hurt, save, revive, recover, kill, injure, affect
starve	starve, kill, eat, harm, hurt, injure, feed, murder, help, oppress
learn	teach, help, influence, instruct, understand, learn, affect, change, educate, benefit
say	say, tell, cause, do, affect, quote, hear, correct, influence, interrupt
wait	delay, wait, stop, kill, follow, be, interrupt, see, avoid, attack
stop	stop, kill, hit, affect, interrupt, hurt, harm, follow, overtake, move
scream	hit, hurt, scream, kill, touch, attack, strike, bite, scare, harm
remain	become, kill, be, replace, remain, remove, affect, leave, destroy, follow
finish	finish, stop, kill, interrupt, start, help, follow, assist, pass, prompt
rise	overcome, kill, influence, affect, move, attack, defeat, overtake, help, harm
break	break, hit, injure, hurt, kill, affect, strike, harm, bend, touch
follow	follow, lead, kill, cause, influence, obey, become, pass, stop, avoid
quit	quit, fire, stop, motivate, kill, lose, beat, hurt, annoy, replace
lie	deceive, mislead, lie, tell, contradict, believe, cheat, fool, inform, correct
disagree	offend, influence, insult, hurt, dislike, contradict, annoy, like, oppose, criticize
graduate	teach, influence, graduate, help, affect, kill, succeed, produce, pass, become
burn	burn, kill, hurt, destroy, fire, touch, ignite, harm, hit, injure
end	kill, stop, end, harm, destroy, terminate, become, affect, cause, hurt
laugh	laugh, amuse, annoy, hit, offend, hurt, provoke, insult, humor, make
strike	strike, hit, attack, injure, hurt, kill, harm, touch, punch, bite
smile	smile, help, greet, compliment, touch, cheer, like, please, amuse, see
hurt	hurt, injure, harm, hit, help, touch, kill, affect, offend, attack
call	call, contact, phone, telephone, answer, reach, tell, be, notify, see
walk	move, hit, walk, touch, kill, follow, stop, help, cross, strike
deliver	deliver, produce, do, kill, execute, receive, give, cause, hit, help
ask	ask, question, tell, answer, help, stop, know, call, prompt, provoke
prevail	defeat, overcome, beat, dominate, control, overtake, kill, destroy, oppress, succeed
stick	hit, hurt, attract, affect, stick, become, be, kill, change, injure
sleep	wake, awaken, disturb, sleep, harm, kill, affect, hit, hurt, awake
apologize	offend, insult, hurt, correct, forgive, blame, hit, criticize, injure, harm
explain	explain, understand, cause, confuse, tell, teach, answer, correct, provoke, contradict
kill	kill, murder, shoot, harm, hurt, injure, attack, hit, destroy, execute
perish	kill, harm, injure, destroy, become, cause, hurt, eat, save, affect
write	write, read, influence, affect, tell, teach, prompt, cause, create, understand
vomit	vomit, kill, eat, hurt, hit, attack, bite, choke, harm, touch
speak	speak, hear, interrupt, affect, understand, tell, correct, say, stop, silence
fold	fold, break, bend, attack, touch, fail, strike, change, deform, flip
agree	persuade, correct, convince, like, please, help, influence, understand, contradict, kill
drown	drown, kill, hit, injure, harm, hurt, affect, attack, destroy, touch
suffice	be, become, kill, satisfy, help, replace, please, harm, save, defeat
care	care, hurt, affect, like, love, influence, help, notice, know, understand
resign	fire, replace, dismiss, influence, kill, hire, remove, bribe, oust, strike
exist	be, become, affect, kill, create, cause, exist, resemble, replace, influence
teach	teach, instruct, influence, tell, correct, educate, affect, help, produce, inform
never	kill, become, be, affect, destroy, hurt, injure, create, cause, change
testify	contradict, tell, believe, witness, accuse, testify, deceive, inform, persuade, refute
collapse	break, destroy, collapse, fail, kill, hit, affect, hurt, harm, injure
vanish	become, kill, be, affect, destroy, harm, replace, cause, create, follow
protest	protest, provoke, offend, hurt, harass, annoy, insult, upset, harm, oppose
decide	choose, decide, influence, cause, affect, kill, tell, persuade, control, change
triumph	defeat, beat, overcome, overtake, destroy, kill, succeed, save, stop, help
sing	sing, hit, hear, affect, harm, imitate, influence, touch, stop, move
stand	move, hit, strike, pass, overcome, attack, touch, help, knock, push
rest	kill, harm, injure, affect, stop, hurt, disturb, strike, wake, hit
count	count, be, kill, beat, affect, equal, hurt, hit, become, harm
drink	drink, influence, affect, harm, kill, cause, hurt, drive, offend, effect
continue	stop, kill, follow, affect, continue, interrupt, cause, destroy, harm, become
crash	crash, hit, impact, kill, affect, hurt, break, cause, damage, strike
escape	kill, escape, attack, harm, hit, injure, hurt, save, stop, destroy
fight	fight, attack, hit, kill, beat, hurt, punch, injure, strike, harm
heal	heal, cure, help, hurt, harm, affect, touch, kill, treat, save
blink	see, blink, wake, hit, affect, touch, notice, confuse, move, distract
soon	kill, hurt, injure, harm, hit, affect, cause, attack, destroy, stop
show	show, see, affect, be, notice, follow, kill, resemble, become, tell
refuse	refuse, reject, resist, deny, kill, ask, offer, oppose, stop, serve
choose	choose, influence, kill, affect, be, become, select, help, change, pick
move	move, touch, hit, affect, follow, hurt, push, kill, stop, influence
watch	watch, see, observe, influence, follow, distract, stop, affect, show, notice
shine	help, influence, affect, benefit, improve, impress, shine, hurt, beat, harm
matter	affect, influence, change, be, matter, become, cause, hurt, help, offend
think	think, affect, cause, influence, provoke, see, tell, understand, stop, do
now	kill, affect, become, cause, be, harm, injure, stop, hurt, do
emerge	become, be, create, kill, cause, affect, influence, change, destroy, overcome
grow	grow, kill, affect, become, produce, change, resemble, eat, hurt, help
visit	visit, see, touch, harm, attract, encounter, contact, meet, influence, kill
play	play, hit, beat, move, affect, influence, interrupt, hurt, stop, kill
fit	fit, become, be, resemble, follow, replace, make, match, join, satisfy
suck	suck, hurt, affect, help, be, annoy, beat, fuck, kill, eat
burst	burst, injure, hurt, break, hit, destroy, harm, explode, rupture, affect
notice	notice, see, affect, observe, influence, recognize, attract, notify, touch, wake
fade	become, affect, be, kill, change, resemble, destroy, replace, lose, hurt
bleed	bleed, kill, hurt, injure, hit, harm, touch, attack, stab, affect
again	kill, hit, attack, hurt, destroy, become, affect, injure, harm, do
share	share, affect, benefit, cause, help, hurt, eat, influence, possess, use
arrive	become, be, cause, kill, follow, produce, receive, stop, affect, meet
anyway	kill, harm, affect, injure, cause, be, hurt, influence, do, like
cave	bite, hurt, attack, hit, kill, cave, eat, injure, harm, deceive
weep	hurt, touch, affect, upset, harm, hit, love, cry, weep, kill
rebel	kill, hurt, attack, influence, offend, harm, provoke, oppose, upset, hate
bail	bail, kill, bribe, shoot, harm, arrest, hurt, rob, sue, charge
forget	forget, remember, hurt, remind, forgive, misunderstand, offend, confuse, ignore, affect
read	read, tell, see, understand, write, influence, teach, distract, affect, hear
bolt	hit, bolt, strike, attack, shoot, kill, hurt, injure, bite, threaten
retaliate	hit, hurt, attack, injure, harm, kill, provoke, insult, strike, threaten
reply	reply, answer, hit, question, provoke, tell, interrupt, insult, correct, quote
crack	crack, break, hit, hurt, injure, kill, harm, fracture, bite, damage
rule	rule, control, influence, dominate, govern, obey, affect, follow, kill, oppress
resist	resist, hurt, harm, attack, oppose, stop, oppress, provoke, kill, fight
appear	become, be, resemble, affect, kill, cause, create, see, attract, follow
appeal	offend, appeal, attack, beat, help, persuade, attract, challenge, injure, oppose
disappoint	disappoint, annoy, please, hurt, impress, fail, surprise, upset, offend, deceive
me	cause, affect, be, hurt, harm, do, me, kill, become, injure
freeze	freeze, kill, touch, stop, hit, affect, hurt, move, attack, harm
pop	pop, hurt, hit, affect, explode, touch, kill, shoot, poke, annoy
sell	sell, buy, produce, purchase, kill, harm, hurt, acquire, destroy, become
shoot	shoot, kill, hit, hurt, injure, harm, attack, fire, provoke, shot
eventually	kill, affect, harm, hurt, injure, destroy, cause, stop, hit, become
pray	pray, help, ask, touch, tell, affect, please, bless, kill, invoke
drive	drive, hit, kill, pass, overtake, influence, cause, stop, affect, control
take	take, kill, give, harm, hit, hurt, attack, cause, bite, eat
land	hit, land, kill, strike, touch, impact, fly, catch, pass, shoot
complain	annoy, offend, insult, complain, criticize, upset, hurt, harass, abuse, blame
thrive	help, benefit, kill, harm, destroy, survive, defeat, affect, overcome, influence
struggle	hurt, help, harm, injure, affect, overcome, kill, influence, hit, defeat
start	stop, kill, start, interrupt, finish, hit, hurt, cause, affect, begin
stink	stink, smell, hurt, kill, harm, smoke, burn, touch, eat, annoy
turn	turn, hit, affect, influence, kill, move, touch, change, stop, attack
comply	obey, kill, help, stop, please, harm, hurt, control, hit, provoke
lead	lead, follow, influence, cause, direct, encourage, help, instruct, assist, drive
succumb	kill, harm, defeat, overcome, hurt, injure, attack, help, destroy, save
hope	hope, help, love, save, believe, wish, encourage, like, inspire, please
ever	kill, injure, affect, cause, harm, become, hurt, be, destroy, hit
expire	kill, become, be, affect, replace, terminate, expire, pass, harm, injure
hit	hit, strike, hurt, injure, kill, punch, impact, touch, affect, harm
choke	choke, kill, bite, hurt, touch, hit, injure, attack, harm, eat
persist	affect, become, be, kill, harm, remain, change, annoy, influence, contradict
vote	influence, affect, elect, vote, help, persuade, kill, change, harm, control
make	make, kill, affect, cause, hurt, create, do, destroy, break, hit
confess	deceive, betray, tell, mislead, accuse, confess, kill, hurt, offend, inform
snap	snap, hit, bite, hurt, kill, injure, slap, punch, break, threaten
evolve	change, become, evolve, influence, affect, resemble, replace, be, modify, create
match	match, be, resemble, become, follow, attract, copy, beat, equal, affect
approve	approve, please, persuade, influence, convince, like, offend, change, help, satisfy
give	give, receive, take, help, get, cause, produce, ask, need, kill
melt	melt, hit, affect, hurt, touch, kill, eat, freeze, move, break
endure	kill, survive, save, hurt, injure, help, harm, overcome, endure, affect
marry	marry, love, kill, become, wed, divorce, be, influence, meet, date
crumble	break, hit, destroy, topple, injure, hurt, damage, kill, harm, affect
decline	affect, influence, harm, kill, replace, become, help, lose, defeat, fail
always	kill, affect, be, become, cause, change, injure, harm, hurt, follow
publish	publish, influence, write, produce, affect, read, kill, inform, quote, follow
serve	serve, help, service, assist, aid, benefit, command, kill, harm, obey
manage	control, manage, affect, influence, kill, injure, help, dominate, restrain, abuse
tweet	tweet, retweet, follow, text, provoke, quote, email, harass, threaten, call
close	close, open, shut, stop, hit, hurt, touch, break, affect, kill
march	march, follow, strike, attack, beat, stop, move, provoke, oppose, fight
though	kill, affect, hit, cause, stop, become, harm, overcome, hurt, influence
hear	hear, tell, affect, understand, see, sound, disturb, interrupt, cause, wake
someday	kill, hurt, harm, injure, affect, hit, cause, be, become, destroy
react	affect, hit, provoke, hurt, touch, harm, attack, influence, kill, effect
sign	sign, write, bind, copy, do, touch, stop, read, represent, notify
look	see, notice, look, touch, follow, hit, approach, watch, observe, affect
kiss	kiss, touch, bite, punch, hit, hug, kill, attack, hurt, love
intervene	help, harm, kill, injure, hurt, provoke, touch, attack, stop, hit
ride	ride, hit, pass, drive, push, hurt, attack, move, overtake, kill
perform	perform, affect, imitate, do, effect, influence, move, provoke, stop, produce
obey	obey, command, please, follow, control, influence, respect, instruct, stop, correct
hold	hold, break, touch, control, bind, hit, take, move, grab, restrain
settle	settle, kill, marry, satisfy, leave, move, affect, become, follow, attract
revolt	kill, attack, harm, hurt, oppress, overthrow, oppose, destroy, injure, hate
drop	drop, hit, move, lift, throw, touch, hurt, affect, kick, push
join	join, follow, kill, help, stop, become, attract, exclude, beat, replace
slip	hit, slip, pass, move, touch, injure, hurt, catch, break, lose
attack	attack, hit, kill, harm, injure, hurt, strike, bite, assault, threaten
believe	believe, deceive, convince, persuade, influence, mislead, tell, help, affect, cause
travel	travel, kill, move, affect, follow, influence, visit, harm, cause, become
attend	attend, invite, influence, teach, affect, see, attract, visit, follow, meet
sink	sink, hit, affect, drown, hurt, kill, harm, help, touch, move
improve	improve, help, benefit, change, affect, influence, harm, hurt, assist, like
argue	argue, insult, refute, influence, interrupt, provoke, persuade, correct, offend, fight
guess	guess, confuse, deceive, tell, mislead, know, answer, surprise, fool, ask
reconsider	change, affect, influence, like, reconsider, persuade, offend, consider, question, hurt
cook	cook, eat, kill, feed, make, attack, fire, produce, help, stir
please	please, help, serve, obey, satisfy, like, respect, impress, assist, benefit
worry	worry, scare, disturb, alarm, bother, hurt, annoy, upset, harm, affect
object	object, affect, effect, cause, hurt, attract, offend, harm, provoke, annoy
qualify	qualify, kill, be, exclude, benefit, become, help, pass, injure, affect
post	post, follow, write, like, update, comment, publish, see, message, tweet
judge	judge, criticize, offend, blame, insult, condemn, harm, punish, question, hurt
volunteer	help, volunteer, aid, assist, recruit, serve, save, hire, kill, fire
erupt	hit, kill, provoke, attack, hurt, injure, explode, destroy, harm, affect
mourn	mourn, hurt, kill, harm, affect, love, injure, upset, hate, offend
next	follow, kill, affect, next, hit, influence, do, stop, cause, attack
relapse	harm, hurt, infect, kill, affect, become, cure, injure, influence, help
rock	rock, hit, hurt, move, kick, kill, affect, damage, injure, influence
faint	hurt, harm, touch, kill, injure, attack, hit, bite, affect, choke
cooperate	help, assist, aid, influence, benefit, deceive, kill, obey, control, cooperate
nap	wake, nap, sleep, disturb, awaken, hit, affect, annoy, beat, hurt
propose	propose, suggest, persuade, oppose, refute, change, influence, affect, contradict, cause
get	get, kill, hit, hurt, injure, harm, give, touch, do, take
convert	convert, kill, become, deceive, change, offend, influence, save, marry, love
yield	yield, obey, deceive, produce, serve, kill, attack, give, satisfy, help
benefit	benefit, help, harm, aid, assist, hurt, influence, affect, favor, injure
regret	hurt, offend, regret, affect, influence, harm, injure, kill, disappoint, blame
act	affect, influence, effect, cause, provoke, kill, harm, control, hit, attack
fry	fry, kill, eat, injure, hurt, attack, harm, hit, bite, touch
pee	pee, touch, piss, affect, hit, wet, hurt, fart, poop, harm
flee	attack, kill, harm, hurt, hit, injure, shoot, strike, threaten, follow
comment	comment, provoke, interrupt, insult, quote, influence, criticize, offend, correct, affect
flip	flip, affect, hit, change, move, touch, influence, switch, kill, turn
confirm	confirm, affirm, contradict, deny, kill, correct, deceive, tell, be, change
ship	ship, kill, destroy, hit, cause, move, sink, affect, drive, hurt
bloom	bloom, kill, affect, attract, harm, flower, grow, hurt, become, destroy
mind	affect, mind, see, influence, notice, think, perceive, remember, know, resemble
adapt	change, affect, influence, help, adapt, modify, become, replace, benefit, overcome
yet	kill, hurt, harm, injure, hit, affect, cause, attack, influence, be
fire	fire, hit, shoot, kill, burn, strike, attack, touch, ignite, harm
dance	move, dance, touch, hit, affect, strike, stop, hurt, provoke, entertain
compete	beat, defeat, challenge, injure, fight, attack, overcome, dominate, help, affect
shout	shout, hit, yell, provoke, interrupt, hear, annoy, call, strike, taunt
report	report, inform, notify, tell, affect, harm, follow, injure, alert, call
wonder	question, ask, confuse, offend, disturb, affect, wonder, understand, influence, surprise
bomb	bomb, attack, kill, hit, harm, hurt, injure, destroy, strike, explode
pull	pull, push, touch, hit, move, hurt, grab, tug, stop, shove
bounce	hit, bounce, move, knock, kick, throw, hurt, bump, touch, affect
save	save, help, kill, rescue, hurt, aid, harm, assist, protect, prevent
dominate	dominate, control, defeat, influence, overcome, beat, overtake, overpower, destroy, conquer
buy	buy, sell, purchase, affect, help, influence, produce, benefit, acquire, kill
blow	blow, hit, kill, strike, injure, touch, attack, hurt, harm, shoot
belong	be, become, join, replace, belong, follow, like, exclude, help, resemble
hang	hang, kill, injure, hit, harm, hurt, shoot, beat, murder, stab
accept	accept, persuade, help, reject, please, convince, like, hurt, change, refuse
sting	sting, hurt, hit, bite, pinch, touch, injure, harm, kick, offend
shrink	shrink, affect, hurt, enlarge, become, eat, injure, change, deform, resemble
slide	hit, move, slide, push, pass, drop, touch, impact, hurt, break
participate	influence, affect, help, provoke, benefit, cause, assist, hurt, effect, involve
meet	meet, become, be, kill, cause, affect, attract, see, create, know
spread	infect, kill, harm, affect, become, spread, cause, influence, attract, destroy
you	cause, kill, hurt, harm, affect, be, injure, do, become, effect
jump	jump, hit, kill, touch, hurt, move, throw, kick, leap, grab
insist	refuse, persuade, resist, contradict, convince, stop, deny, refute, oppose, correct
leak	leak, harm, affect, hurt, infect, touch, damage, hit, eat, flood
rot	kill, eat, destroy, hurt, harm, affect, corrupt, rot, infect, damage
rebuild	rebuild, destroy, repair, kill, replace, heal, damage, build, hurt, injure
check	check, see, hit, touch, attack, test, kill, knock, cross, stop
occur	affect, kill, be, cause, become, harm, influence, effect, do, injure
cease	stop, cease, kill, harm, become, affect, interrupt, be, halt, cause
apply	affect, be, effect, become, influence, apply, cause, harm, offend, benefit
panic	scare, panic, alarm, hurt, harm, kill, attack, threaten, touch, hit
keep	keep, kill, get, lose, harm, hurt, destroy, like, save, become
find	find, kill, seek, locate, see, discover, get, tell, attract, detect
pick	pick, choose, select, hit, kill, move, hurt, get, eat, affect
bark	bark, bite, hit, attack, hurt, harm, annoy, wake, threaten, provoke
tomorrow	kill, injure, affect, harm, hurt, cause, become, influence, be, destroy
today	kill, become, affect, be, cause, harm, injure, influence, hurt, create
connect	connect, affect, touch, cause, influence, attract, help, become, understand, know
linger	disturb, follow, affect, kill, bother, annoy, touch, visit, provoke, become
hesitate	stop, provoke, delay, question, interrupt, offend, attack, threaten, hurt, fear
admit	deceive, admit, deny, mislead, tell, correct, acknowledge, believe, know, hurt
surrender	kill, disarm, attack, shoot, surrender, defeat, harm, fight, obey, destroy
smoke	smoke, harm, touch, fire, burn, kill, influence, hurt, possess, affect
arise	become, cause, be, create, affect, produce, kill, contradict, influence, make
tonight	kill, injure, hurt, harm, hit, affect, cause, influence, attack, destroy
indeed	kill, hurt, harm, injure, hit, affect, attack, be, influence, become
feast	feast, eat, feed, offend, kill, starve, attack, consume, please, benefit
bitch	bitch, hit, annoy, insult, curse, bully, hurt, hate, upset, harass
release	release, control, trigger, free, affect, hurt, kill, make, activate, create
bake	bake, cook, eat, make, affect, hurt, hit, produce, kill, burn
pitch	pitch, hit, strike, catch, throw, contact, help, affect, batter, beat
prosper	benefit, harm, help, defeat, prosper, destroy, hurt, aid, kill, favor
swear	curse, swear, insult, offend, kiss, tell, abuse, hit, threaten, hurt
blog	blog, write, visit, post, comment, read, follow, quote, publish, tell
contribute	help, benefit, affect, assist, cause, influence, aid, produce, effect, contribute
yell	yell, hit, shout, annoy, provoke, interrupt, attack, insult, call, hear
promise	promise, threaten, deceive, harm, be, like, become, tell, believe, hurt
sit	move, sit, seat, touch, hit, push, follow, pass, hold, help
shave	shave, kill, touch, bite, cut, shoot, hit, kiss, see, injure
adjust	affect, change, adjust, effect, influence, correct, modify, alter, help, move
fuck	fuck, screw, fucking, hit, kill, rape, suck, hurt, kiss, touch
shatter	break, hit, shatter, destroy, strike, injure, smash, hurt, damage, affect
Die	kill, die, harm, hurt, destroy, injure, become, be, cause, eat
dream	dream, wake, see, influence, affect, kill, awaken, be, deceive, become
execute	execute, kill, attack, command, trigger, control, do, obey, hit, shoot
elaborate	provoke, interrupt, confuse, imitate, delay, understand, amuse, explain, annoy, insult
right	correct, move, right, hit, help, wrong, cause, hurt, follow, affect
out	kill, out, hit, affect, hurt, attack, strike, expel, stop, harm
behave	affect, influence, effect, control, behave, harm, provoke, hurt, obey, cause
maybe	affect, hurt, cause, like, hit, be, help, kill, influence, get
destroy	destroy, kill, harm, create, injure, attack, damage, hurt, cause, break
swallow	swallow, eat, bite, kill, choke, hit, hurt, punch, drown, affect
rain	hit, rain, affect, wet, hurt, flood, kill, strike, drown, harm
test	test, affect, effect, fail, detect, provoke, hit, hurt, infect, tell
knock	knock, hit, push, strike, bang, wake, punch, bump, kick, move
rally	rally, provoke, attack, help, hit, support, fight, oppose, encourage, affect
regress	affect, change, influence, regress, harm, hurt, cause, become, be, effect
prove	prove, refute, contradict, convince, be, deny, cause, find, produce, show
buckle	buckle, hurt, hit, injure, bend, push, move, strike, stop, choke
suit	suit, attract, affect, please, follow, satisfy, like, influence, be, change
hide	hide, deceive, see, kill, harm, hurt, attack, follow, find, conceal
then	cause, kill, become, be, affect, then, do, follow, stop, injure
study	study, influence, affect, teach, read, observe, understand, effect, stimulate, help
swim	drown, kill, swim, hit, save, attack, affect, hurt, bite, touch
inherit	inherit, become, replace, influence, produce, create, kill, be, affect, destroy
reign	control, rule, overthrow, destroy, become, kill, be, oppress, govern, defeat
regenerate	regenerate, kill, heal, affect, harm, become, revive, replace, save, destroy
retweet	retweet, tweet, follow, like, tag, quote, troll, reply, engage, message
clarify	confuse, clarify, correct, provoke, understand, contradict, clear, answer, explain, cause
cross	cross, touch, kill, pass, hit, follow, see, move, harm, hurt
submit	submit, obey, kill, resist, attack, control, persuade, defeat, oppress, please
beg	beg, bribe, ask, kill, harm, help, hurt, want, refuse, bite
need	need, require, help, use, aid, want, harm, have, benefit, hurt
whine	whine, annoy, upset, affect, bother, hurt, insult, hit, complain, tell
relent	stop, resist, kill, restrain, obey, defeat, attack, hurt, hit, disarm
donate	help, give, donate, benefit, aid, feed, assist, save, kill, support
later	kill, affect, injure, harm, hurt, cause, become, follow, delay, be
exit	exit, enter, attack, follow, stop, kill, hit, affect, interrupt, leave
draw	draw, provoke, touch, write, attract, hit, paint, see, move, create
investigate	investigate, attack, provoke, pursue, find, disturb, question, examine, affect, probe
click	click, touch, hit, move, see, attract, bite, influence, follow, trigger
himself	harm, cause, injure, kill, hurt, affect, attack, do, hit, destroy
beat	beat, defeat, hit, kill, hurt, catch, injure, attack, fight, knock
celebrate	celebrate, love, offend, hurt, surprise, help, congratulate, cheer, encourage, kill
surprise	surprise, shock, hurt, confuse, provoke, scare, deceive, disturb, impress, upset
depart	become, leave, follow, kill, affect, injure, cause, harm, influence, replace
wake	wake, awaken, awake, disturb, alert, move, see, alarm, hit, sleep
spill	spill, hit, hurt, affect, touch, splash, drink, drown, kill, wet
soar	lift, help, hurt, fly, kill, influence, hit, affect, harm, cause
cheat	cheat, deceive, beat, betray, trick, defeat, bribe, hurt, corrupt, harm
point	point, hit, provoke, poke, stop, move, touch, correct, interrupt, follow
open	open, close, shut, break, stop, unlock, enter, kill, hurt, reopen
cope	affect, help, hurt, harm, kill, control, hit, cause, injure, effect
wander	follow, disturb, harm, leave, cross, affect, influence, kill, attract, move
probably	kill, hurt, harm, injure, hit, affect, attack, be, cause, destroy
begin	stop, kill, begin, become, start, interrupt, follow, be, create, cause
repeat	repeat, imitate, interrupt, contradict, affect, follow, become, kill, replace, copy
kick	kick, hit, punch, hurt, push, kill, bite, move, beat, knock
freak	freak, hurt, injure, affect, hit, upset, scare, shock, kill, harm
tire	tire, hurt, injure, exhaust, kill, affect, hit, stop, move, strike
enter	enter, stop, exit, attack, kill, harm, follow, leave, destroy, pass
forever	kill, become, affect, hurt, destroy, harm, injure, be, stop, change
stumble	hit, hurt, injure, touch, cross, stumble, move, push, strike, pass
translate	translate, understand, tell, speak, confuse, correct, affect, read, copy, follow
battle	fight, battle, attack, defeat, kill, hit, beat, harm, injure, destroy
feel	affect, feel, touch, hurt, effect, cause, make, harm, hit, move
also	affect, kill, injure, cause, be, harm, hurt, do, become, effect
concede	defeat, concede, deceive, correct, beat, lose, cheat, kill, help, persuade
split	split, separate, kill, break, hurt, divide, injure, affect, destroy, harm
cure	cure, heal, help, treat, cause, kill, affect, harm, prevent, hurt
surface	become, affect, cause, kill, be, create, influence, provoke, attract, harm
catch	catch, hit, grab, capture, chase, get, kill, throw, bite, pass
coach	coach, beat, injure, defeat, help, motivate, influence, teach, play, lose
climb	climb, hit, move, kill, pass, help, jump, lift, push, knock
back	hit, push, back, move, strike, attack, kick, touch, hurt, knock
date	date, be, affect, harm, become, kill, cause, follow, create, produce
register	register, notify, be, affect, recognize, become, cause, see, kill, identify
want	want, desire, like, help, get, affect, hurt, satisfy, need, ask
poop	poop, fart, dump, kill, eat, kick, hurt, hit, pee, touch
pause	stop, interrupt, pause, delay, disturb, hit, affect, slow, kill, halt
enlist	enlist, recruit, kill, attack, serve, help, fight, defeat, join, aid
switch	change, switch, affect, become, kill, influence, control, be, replace, confuse
plead	plead, persuade, help, resist, charge, bribe, accuse, beg, hurt, offend
either	kill, affect, cause, injure, harm, be, hit, hurt, become, do
cover	cover, hit, avoid, touch, kill, hide, catch, injure, cross, move
spring	spring, kill, attack, shoot, hurt, hit, provoke, strike, wake, cause
hate	hate, love, dislike, like, hurt, despise, harm, kill, attack, offend
toast	toast, wake, burn, kill, fry, eat, offend, touch, hit, roast
race	race, kill, beat, overtake, drive, attack, injure, harm, hurt, fight
repent	forgive, kill, convert, hurt, offend, harm, love, help, change, save
experiment	affect, experiment, provoke, influence, effect, stimulate, cause, observe, test, control
form	become, create, be, form, affect, resemble, make, change, produce, cause
kid	kill, hurt, hit, injure, bite, harm, affect, attack, annoy, like
balk	offend, provoke, hurt, upset, balk, annoy, stop, attack, question, alarm
develop	affect, develop, become, change, influence, produce, create, be, cause, resemble
merge	merge, become, affect, kill, influence, create, change, be, join, destroy
still	stop, kill, move, become, affect, be, touch, cause, wake, harm
Fall	hit, kill, fall, injure, strike, harm, attack, hurt, affect, impact
score	score, beat, defeat, hit, injure, kill, cheat, pass, kick, catch
inspire	inspire, motivate, provoke, encourage, influence, attract, create, cause, affect, stimulate
question	question, ask, offend, provoke, confuse, answer, challenge, contradict, influence, criticize
feed	feed, eat, kill, harm, starve, consume, produce, attack, hurt, injure
clean	clean, wash, kill, hit, lick, help, destroy, scrub, touch, wipe
excel	help, improve, beat, defeat, succeed, benefit, surpass, influence, overcome, teach
snow	snow, hit, kill, injure, move, hurt, harm, affect, melt, touch
jail	hurt, kill, harm, injure, arrest, shoot, hit, beat, attack, jail
account	injure, cause, affect, blame, attack, harm, provoke, kill, effect, correct
rejoice	help, love, please, hurt, upset, kill, cheer, annoy, harm, hate
apologise	offend, insult, correct, hurt, forgive, blame, provoke, harm, bully, hit
rebound	hit, affect, hurt, kill, attack, destroy, harm, rebound, beat, injure
rap	rap, beat, hit, annoy, provoke, harm, interrupt, hurt, hear, silence
recognize	recognize, see, notice, know, identify, resemble, understand, distinguish, perceive, recognise
err	err, offend, harm, injure, influence, annoy, hurt, affect, deceive, abuse
roar	roar, hit, attack, hear, annoy, kill, wake, strike, hurt, harm
correct	correct, contradict, affect, change, deceive, teach, confuse, instruct, help, follow
shift	move, shift, affect, change, influence, become, effect, be, alter, touch
commit	commit, kill, attack, hurt, provoke, harm, cause, hit, murder, stop
blame	blame, injure, hurt, cause, kill, harm, hit, abuse, attack, influence
here	be, kill, become, cause, affect, harm, hit, follow, injure, hurt
become	become, be, create, change, make, remain, resemble, kill, cause, affect
shut	shut, open, close, silence, stop, block, hit, hurt, affect, lock
recall	recall, remember, remind, affect, recognize, trigger, forget, tell, influence, notice
trip	hit, trip, impact, hurt, injure, pass, touch, strike, affect, knock
ascend	elevate, kill, overcome, influence, ascend, defeat, pass, follow, affect, overtake
rank	rank, beat, influence, overtake, defeat, replace, surpass, improve, affect, pass
I	kill, injure, harm, hurt, hit, affect, be, attack, become, cause
wear	wear, affect, be, become, hurt, injure, harm, attract, see, resemble
roll	roll, hit, move, push, hurt, knock, kill, throw, flip, strike
love	love, like, hate, hurt, affect, dislike, kill, harm, understand, help
nod	nod, acknowledge, touch, move, answer, see, correct, greet, hear, notice
flourish	harm, benefit, help, become, kill, destroy, influence, be, affect, produce
figure	figure, be, affect, become, follow, cause, tell, contradict, hit, make
transform	transform, change, become, affect, alter, be, create, influence, replace, modify
died	kill, die, harm, hurt, injure, cause, killed, become, be, eat
steal	steal, harm, hurt, rob, kill, injure, attack, hit, break, possess
launch	launch, kill, spawn, become, hit, stop, attack, impact, affect, create
refrain	stop, offend, harm, provoke, avoid, interrupt, discourage, attack, restrain, kill
flood	flood, drown, affect, destroy, overflow, harm, hit, sink, water, overwhelm
death	kill, injure, harm, hurt, hit, murder, attack, destroy, shoot, strike
interfere	influence, interrupt, harm, provoke, affect, interfere, injure, disturb, impede, help
bed	wake, bed, disturb, kill, sleep, awaken, harm, hit, beat, affect
attest	kill, injure, harm, hurt, affect, hit, cause, influence, attack, be
shrug	shrug, hit, slap, insult, mock, taunt, touch, punch, annoy, dismiss
expand	expand, enlarge, become, contain, affect, shrink, grow, exceed, be, increase
breathe	touch, kill, breathe, affect, save, help, hurt, hit, harm, move
float	float, hit, affect, move, fly, touch, lift, kill, influence, pass
cut	cut, bite, hurt, hit, kill, injure, slash, touch, strike, harm
wink	wink, kiss, touch, see, notice, deceive, punch, hit, slap, taunt
conform	change, please, become, influence, be, resemble, follow, obey, affect, like
first	kill, first, hit, cause, affect, follow, be, harm, stop, injure
star	star, affect, attract, harm, influence, kill, hurt, help, cause, hit
disperse	disperse, attract, affect, kill, follow, disturb, attack, harm, destroy, hit
ruin	ruin, destroy, harm, hurt, kill, injure, affect, save, spoil, cause
produce	produce, cause, create, affect, make, effect, kill, destroy, influence, reproduce
demonstrate	demonstrate, show, produce, teach, provoke, see, affect, observe, cause, injure
cancel	cancel, affect, stop, replace, kill, effect, interrupt, attract, delay, annoy
swing	swing, hit, strike, punch, throw, kick, move, hurt, kill, injure
him	kill, cause, harm, hurt, be, affect, injure, do, hit, become
terminate	terminate, kill, affect, destroy, harm, stop, injure, cause, become, interrupt
result	affect, cause, effect, kill, be, influence, harm, become, produce, do
dissolve	dissolve, destroy, affect, become, kill, create, change, break, overcome, separate
smell	smell, touch, scent, sniff, stink, affect, taste, hurt, smoke, odor
note	notice, note, affect, tell, see, observe, write, touch, hear, kill
identify	identify, recognize, resemble, become, see, know, kill, be, distinguish, affect
bet	bet, beat, hit, lose, tell, pay, hurt, bribe, attack, cheat
preach	teach, offend, preach, tell, contradict, convince, persuade, influence, encourage, refute
ring	call, ring, hit, touch, phone, answer, wake, contact, telephone, hear
edit	edit, copy, modify, update, affect, change, delete, alter, interrupt, write
wish	wish, cause, please, help, affect, desire, harm, influence, do, be
despair	harm, hurt, kill, affect, upset, hate, injure, destroy, annoy, blame
differ	be, affect, influence, change, resemble, become, contradict, differ, cause, separate
like	like, dislike, love, hate, please, hurt, help, affect, annoy, respect
hunt	hunt, kill, eat, shoot, chase, attack, harm, injure, follow, pursue
collect	collect, attract, buy, produce, acquire, hit, consume, catch, get, pay
set	set, move, affect, correct, hit, reset, break, kill, make, put
spawn	spawn, kill, create, become, produce, infect, cause, be, affect, destroy
cough	cough, choke, wake, touch, hit, smoke, hurt, annoy, infect, attack
finally	kill, hurt, harm, injure, hit, affect, attack, destroy, cause, help
awake	wake, awaken, awake, disturb, alert, see, affect, sleep, kill, harm
deploy	deploy, activate, attack, kill, disable, execute, dispatch, fire, command, affect
push	push, shove, hit, pull, move, touch, hurt, prod, punch, stop
instead	kill, affect, be, stop, become, cause, harm, hurt, hit, injure
glow	glow, illuminate, touch, light, affect, harm, attract, see, kill, burn
plan	plan, cause, affect, influence, prevent, control, effect, execute, kill, stop
dead	kill, harm, injure, murder, hurt, hit, eat, die, destroy, be
joke	joke, insult, humor, mock, ridicule, tell, offend, amuse, provoke, laugh
mean	mean, be, become, say, cause, do, affect, kill, describe, create
bond	bond, love, affect, touch, attract, like, hurt, harm, bind, help
forgive	forgive, love, hurt, offend, help, hate, blame, like, kill, understand
us	cause, be, affect, harm, kill, hurt, injure, become, do, create
camp	kill, hurt, harm, hit, injure, attack, provoke, affect, strike, destroy
well	harm, kill, hurt, help, hit, affect, injure, influence, beat, cause
Tweet	tweet, retweet, follow, text, call, threaten, tell, provoke, taunt, prompt
claim	claim, deny, be, deceive, attack, own, kill, take, exclude, harm
haunt	haunt, kill, harm, attack, visit, hit, hurt, murder, injure, torment
use	use, harm, affect, help, injure, hurt, kill, abuse, effect, cause
only	affect, be, cause, become, kill, harm, injure, hurt, destroy, stop
resonate	influence, affect, offend, inspire, touch, resemble, motivate, provoke, evoke, like
direct	direct, cause, influence, affect, provoke, redirect, control, hit, instruct, contact
shop	buy, affect, shop, influence, harm, offend, help, sell, cause, kill
actually	kill, be, affect, cause, harm, do, become, effect, hit, hurt
grin	smile, kiss, amuse, annoy, cheer, like, see, grin, laugh, compliment
leap	leap, jump, hit, move, pass, catch, kill, touch, overcome, throw
focus	distract, affect, influence, focus, help, see, confuse, attract, stop, notice
state	state, contradict, cause, say, tell, affect, notify, correct, inform, follow
mine	mine, attack, kill, harm, injure, affect, be, possess, destroy, make
loose	loose, hurt, injure, lose, break, kill, release, move, touch, drop
command	command, obey, control, cause, provoke, order, attack, call, execute, correct
prison	kill, hurt, harm, injure, murder, attack, hit, shoot, offend, execute
really	affect, hurt, kill, harm, hit, cause, be, believe, help, effect
age	affect, kill, age, become, influence, injure, resemble, harm, hurt, replace
in	kill, hit, affect, injure, enter, in, harm, hurt, attack, strike
reveal	reveal, tell, deceive, expose, see, show, inform, betray, disclose, cause
cheer	cheer, encourage, help, beat, annoy, congratulate, move, upset, greet, taunt
escalate	provoke, escalate, hurt, attack, kill, harm, threaten, fight, injure, hit
enroll	enroll, influence, recruit, teach, notify, be, instruct, become, affect, invite
wreck	wreck, hit, destroy, kill, damage, crash, cause, hurt, injure, impact
provide	provide, give, produce, help, supply, assist, serve, require, cause, need
witness	witness, see, cause, observe, affect, influence, touch, watch, provoke, tell
print	print, publish, write, copy, read, affect, tell, touch, produce, reproduce
prosecute	prosecute, indict, sue, pursue, harass, convict, injure, charge, attack, hurt
touch	touch, hit, hurt, contact, affect, harm, strike, move, kiss, grab
overdose	kill, overdose, harm, poison, hurt, injure, affect, infect, impair, cause
blush	insult, touch, kiss, embarrass, offend, blush, mock, hurt, compliment, annoy
will	will, kill, affect, influence, cause, do, make, control, wish, obey
send	send, receive, contact, write, tell, notify, email, give, mail, get
revert	affect, change, kill, become, influence, revert, correct, be, control, harm
withdraw	provoke, attack, harm, hurt, offend, influence, threaten, stop, withdraw, annoy
carry	carry, kill, move, hurt, hit, injure, cause, eat, harm, lift
default	override, kill, be, affect, become, correct, control, choose, influence, change
train	train, affect, teach, injure, attack, hurt, defeat, help, kill, drive
bend	bend, break, move, hurt, hit, deform, affect, turn, push, touch
practice	teach, affect, influence, imitate, practice, help, effect, offend, hurt, benefit
slay	slay, kill, shoot, murder, destroy, attack, harm, hit, injure, fight
whistle	whistle, hear, stop, wake, interrupt, annoy, tell, disturb, blow, call
tie	tie, bind, touch, hurt, bite, hit, kill, join, injure, restrain
failed	kill, harm, hurt, injure, hit, affect, destroy, attack, be, become
sew	sew, kill, bind, hurt, make, injure, stitch, affect, touch, create
ski	ski, kill, injure, shoot, hit, kick, hurt, lift, pass, move
subscribe	follow, obey, please, become, inform, influence, like, teach, change, subscribe
awaken	awaken, wake, awake, disturb, alert, affect, kill, revive, sleep, harm
it	kill, harm, cause, affect, injure, hurt, be, attack, hit, do
dare	dare, challenge, provoke, offend, threaten, scare, hurt, touch, attack, harm
already	kill, hurt, harm, injure, affect, hit, attack, become, be, stop
slow	slow, stop, delay, accelerate, speed, kill, affect, hurt, slower, move
debut	become, be, affect, resemble, kill, attract, create, change, manifest, produce
tear	tear, hurt, touch, hit, break, affect, rip, injure, move, harm
shortly	kill, hurt, harm, injure, hit, affect, attack, cause, influence, touch
interrupt	interrupt, disturb, stop, distract, disrupt, delay, hear, annoy, affect, obstruct
clash	hurt, hit, attack, kill, affect, influence, harm, annoy, injure, provoke
deal	harm, affect, hurt, cause, hit, deal, kill, effect, injure, help
nurse	nurse, kill, milk, hurt, feed, eat, infect, injure, harm, hit
fragment	fragment, break, affect, destroy, separate, injure, become, harm, split, damage
better	improve, help, better, benefit, like, hurt, affect, harm, beat, make
build	build, destroy, kill, create, make, break, attack, help, cause, construct
child	kill, injure, harm, hurt, hit, affect, attack, cause, destroy, be
one	kill, cause, affect, injure, harm, hurt, hit, be, do, attack
soften	soften, hurt, change, hit, affect, offend, touch, move, like, injure
fast	slow, stop, eat, fast, kill, delay, wake, speed, accelerate, beat
attempt	attempt, kill, attack, harm, injure, try, help, hurt, assist, prevent
punch	punch, hit, strike, attack, hurt, bite, slap, kick, fight, beat
power	influence, control, power, defeat, harm, affect, kill, dominate, become, overthrow
overcome	overcome, defeat, beat, help, conquer, overpower, affect, overtake, kill, stop
sweep	sweep, hit, overtake, wake, move, strike, destroy, pass, affect, kill
book	read, book, kill, attack, tell, write, harm, affect, hit, bite
respawn	kill, respawn, shoot, attack, hit, destroy, revive, spawn, execute, defeat
curse	curse, insult, offend, hurt, harm, annoy, bless, hate, hit, taunt
charge	charge, injure, hurt, attack, hit, pay, punch, provoke, sue, harm
rip	rip, hit, break, cut, hurt, bite, tear, touch, damage, pull
relate	relate, affect, cause, resemble, like, influence, help, understand, describe, tell
disarm	disarm, kill, harm, attack, shoot, strike, hurt, injure, hit, disable
whisper	hear, whisper, interrupt, touch, tell, say, wake, disturb, speak, hit
let	let, hurt, kill, allow, help, make, give, release, get, free
transfer	transfer, become, affect, change, be, acquire, kill, replace, create, move
increase	increase, affect, influence, decrease, harm, reduce, kill, help, cause, hurt
gain	benefit, defeat, harm, help, gain, lose, injure, favor, hurt, assist
chuckle	amuse, laugh, humor, annoy, offend, mock, chuckle, taunt, provoke, touch
swell	swell, injure, hurt, enlarge, grow, shrink, harm, affect, hit, crush
multiply	multiply, affect, become, kill, produce, be, create, increase, divide, attract
pump	pump, hit, kill, stimulate, hurt, affect, milk, feed, push, stop
murder	kill, murder, harm, shoot, injure, hurt, attack, destroy, stab, hit
morph	become, morph, change, be, resemble, affect, transform, create, modify, kill
part	separate, hurt, affect, harm, part, kill, injure, touch, bite, hit
update	update, change, notify, follow, inform, modify, affect, edit, copy, correct
left	leave, hit, kill, become, affect, move, follow, hurt, cause, injure
double	double, hit, multiply, kill, become, be, increase, equal, affect, exceed
combust	burn, ignite, combust, kill, hurt, destroy, affect, harm, fire, injure
fracture	break, fracture, injure, hurt, harm, hit, affect, damage, deform, touch
retreat	attack, hit, provoke, harm, hurt, kill, strike, stop, threaten, follow
realize	realize, see, affect, cause, notice, deceive, recognize, influence, understand, perceive
dry	dry, wet, water, touch, kill, drain, piss, eat, drown, bleed
wave	wave, hit, touch, strike, move, affect, attack, slap, flip, push
spoil	spoil, ruin, harm, hurt, injure, destroy, eat, starve, upset, annoy
sweat	sweat, touch, hit, affect, hurt, wake, wet, injure, bite, strike
relax	relax, calm, help, comfort, affect, restrain, hurt, relieve, reassure, please
text	text, tell, write, read, follow, describe, affect, interrupt, quote, message
bear	bear, injure, kill, hit, hurt, harm, attack, cause, affect, strike
reconcile	reconcile, love, forgive, kill, hurt, affect, understand, change, help, marry
swarm	swarm, attack, kill, attract, eat, bite, affect, harm, hit, hurt
collaborate	influence, help, assist, benefit, cause, aid, affect, provoke, motivate, effect
reverse	reverse, affect, change, influence, effect, kill, correct, become, cause, do
cost	cost, benefit, save, harm, be, hurt, kill, pay, consume, cause
block	block, interrupt, stop, obstruct, hit, kill, prevent, delay, affect, break
black	kill, black, be, see, burn, color, hit, hurt, become, harm
thank	thank, repay, help, insult, please, pay, hurt, bless, save, serve
declare	declare, notify, cause, tell, deny, inform, destroy, contradict, be, kill
own	own, possess, control, buy, be, destroy, have, acquire, produce, become
experience	affect, cause, experience, effect, influence, touch, see, provoke, create, perceive
adopt	adopt, become, change, replace, kill, love, like, be, marry, influence
advance	advance, influence, move, affect, help, overcome, overtake, benefit, stop, pass
complete	complete, finish, kill, stop, create, help, do, execute, follow, make
descend	descend, become, follow, kill, influence, ascend, produce, affect, raise, destroy
function	affect, function, cause, do, control, be, obey, effect, help, influence
step	move, stop, follow, hit, touch, strike, cross, harm, pass, step
announce	announce, notify, inform, tell, interrupt, call, alert, affect, introduce, warn
reload	reload, shoot, kill, hit, attack, fire, disable, execute, stop, destroy
add	subtract, add, remove, replace, affect, follow, make, change, join, kill
skate	skate, kill, hit, beat, move, kick, push, affect, cross, injure
spike	spike, affect, hurt, hit, kill, harm, touch, increase, attack, jump
resolve	resolve, affect, kill, cause, overcome, solve, provoke, move, change, hit
up	hit, move, lift, hurt, knock, affect, kick, push, raise, wake
assist	assist, help, aid, serve, benefit, rescue, support, instruct, save, harm
boy	kill, hurt, injure, harm, hit, attack, affect, destroy, be, touch
dies	kill, harm, injure, die, hurt, eat, cause, destroy, affect, become
chill	chill, disturb, kill, annoy, affect, calm, stop, hit, touch, hurt
search	search, find, seek, follow, locate, query, ask, attract, hunt, see
offer	offer, give, help, refuse, ask, serve, provide, assist, receive, be
measure	measure, affect, weigh, effect, cause, tell, move, observe, be, increase
spit	spit, bite, hit, swallow, insult, spew, touch, punch, attack, fire
profit	benefit, harm, profit, help, influence, hurt, injure, favor, affect, kill
bow	bow, hit, touch, strike, obey, respect, stop, move, bend, please
eject	eject, hit, kill, attack, expel, shoot, injure, punch, strike, affect
shed	shed, affect, hurt, consume, eat, attract, kill, lose, produce, burn
bust	bust, break, hurt, hit, injure, crack, crush, smash, harm, kill
jam	jam, hit, ram, hurt, kill, move, affect, harm, slam, block
corrupt	corrupt, bribe, destroy, harm, influence, deceive, affect, elect, corrupted, control
wipe	wipe, touch, affect, hit, wash, kill, infect, destroy, eat, wake
cringe	hurt, offend, scare, touch, annoy, provoke, insult, bite, embarrass, mock
sigh	sigh, annoy, upset, touch, hurt, hit, kiss, affect, curse, criticize
veto	veto, override, influence, oppose, kill, control, stop, trump, block, deny
scar	scar, injure, hurt, harm, hit, affect, kill, touch, resemble, damage
plummet	kill, hit, harm, affect, drop, hurt, destroy, influence, injure, lower
cycle	cycle, affect, influence, kill, effect, change, attract, reproduce, produce, spin
scatter	hit, scatter, strike, affect, kill, follow, injure, attack, harm, move
wrestle	wrestle, hit, fight, attack, injure, challenge, defeat, strike, hurt, beat
indict	indict, injure, hurt, corrupt, attack, harm, accuse, provoke, oppress, murder
hurry	hurry, delay, stop, rush, follow, accelerate, slow, pass, move, speed
disapprove	dislike, offend, criticize, like, disapprove, annoy, influence, harm, please, upset
game	kill, game, play, defeat, beat, shoot, hit, get, attack, affect
fart	fart, smell, touch, hurt, affect, expel, kill, kick, harm, eat
hire	hire, employ, fire, kill, pay, replace, recruit, help, like, be
compensate	compensate, help, injure, hurt, kill, hit, affect, benefit, correct, harm
assume	assume, be, become, deceive, believe, correct, expect, tell, contradict, mislead
signal	signal, tell, notify, see, hear, indicate, communicate, warn, call, cause
sacrifice	sacrifice, kill, harm, hurt, save, help, murder, injure, become, love
suspect	suspect, deceive, accuse, know, believe, question, doubt, fear, offend, mislead
prepare	prepare, warn, provoke, prevent, delay, help, surprise, cause, prompt, preempt
stir	stir, wake, awaken, provoke, disturb, affect, strike, hurt, touch, move
relocate	relocate, move, kill, harm, affect, become, injure, hurt, follow, cause
roast	roast, eat, kill, attack, burn, hurt, fire, hate, harm, injure
lapse	become, affect, kill, injure, pass, override, be, influence, fail, harm
free	free, liberate, release, help, break, kill, save, harm, become, escape
somehow	kill, affect, cause, harm, hurt, influence, injure, help, hit, do
topple	topple, hit, kill, move, destroy, knock, break, overthrow, harm, strike
tour	injure, affect, harm, kill, hurt, attack, visit, follow, attract, be
offend	offend, insult, hurt, provoke, harm, annoy, injure, upset, attack, affect
sail	hit, sail, cause, destroy, kill, harm, injure, strike, sink, affect
hatch	hatch, eat, kill, infect, spawn, egg, attract, feed, bite, become
rant	rant, insult, annoy, provoke, offend, anger, criticize, upset, harass, abuse
fish	fish, kill, eat, catch, bite, hit, fry, injure, hurt, attack
proceed	follow, stop, cause, kill, affect, prevent, assist, pass, harm, move
dig	dig, hurt, hit, bury, kill, eat, push, move, touch, attack
crater	crater, hit, hurt, affect, impact, harm, injure, damage, crash, destroy
wash	wash, touch, hit, clean, water, shower, rinse, affect, wet, splash
light	light, illuminate, see, harm, affect, hurt, touch, kill, hit, deceive
shit	shit, fuck, hit, piss, kill, hurt, injure, bite, kick, touch
throw	throw, hit, punch, toss, kick, catch, push, hurt, strike, touch
boom	hit, hurt, affect, kill, harm, help, stimulate, beat, destroy, be
upload	upload, edit, post, copy, download, follow, create, attract, publish, become
reform	reform, change, correct, affect, influence, improve, replace, transform, help, become
divine	divine, affect, cause, produce, create, influence, harm, be, injure, destroy
mend	mend, heal, break, hurt, injure, harm, help, change, fix, repair
satisfy	satisfy, please, obey, be, become, fulfill, attract, kill, affect, make
predict	predict, influence, cause, affect, tell, be, anticipate, attract, warn, follow
myself	harm, cause, injure, affect, kill, hurt, be, attack, do, become
convict	convict, offend, punish, injure, murder, corrupt, kill, oppress, indict, condemn
litter	litter, kill, hit, annoy, eat, injure, hurt, attract, harm, destroy
progress	help, affect, assist, benefit, stop, progress, kill, move, change, overcome
RIP	kill, harm, injure, die, hit, affect, become, attack, be, destroy
more	affect, increase, hurt, harm, kill, more, cause, hit, attract, help
discover	discover, find, tell, inform, know, reveal, see, detect, teach, cause
boot	boot, kick, hurt, kill, be, bite, harm, follow, stop, shoot
design	design, create, influence, cause, affect, change, redesign, make, control, modify
divide	divide, separate, affect, become, cross, split, cause, destroy, lose, kill
herself	harm, cause, hurt, injure, kill, affect, attack, do, effect, hit
police	harm, provoke, kill, injure, attack, hurt, shoot, arrest, police, stop
vent	vent, annoy, upset, provoke, hurt, anger, affect, incite, criticize, offend
okay	hurt, harm, kill, affect, hit, attack, injure, stop, help, touch
rupture	rupture, break, hurt, injure, hit, destroy, harm, breach, damage, affect
rage	anger, rage, hurt, hit, attack, provoke, kill, hate, insult, abuse
capture	capture, catch, attack, kill, hit, bite, injure, grab, apprehend, strike
shudder	touch, scare, shudder, hurt, shake, move, fear, hit, harm, disturb
reach	reach, touch, hit, strike, injure, affect, pass, harm, hurt, cause
fix	fix, affect, change, correct, cause, break, kill, make, help, hit
bless	bless, curse, offend, help, harm, benefit, love, serve, affect, please
box	box, hit, knock, control, affect, hurt, provoke, block, upset, punch
handle	handle, hit, affect, hurt, attack, harm, control, injure, abuse, grab
conquer	conquer, defeat, overcome, destroy, dominate, beat, kill, overtake, oppress, control
after	kill, hurt, harm, hit, injure, affect, attack, be, cause, destroy
court	sue, injure, hurt, harm, attack, court, harass, kill, threaten, offend
control	control, influence, affect, dominate, manipulate, command, cause, touch, kill, obey
shove	shove, push, hit, punch, hurt, touch, move, throw, hug, kick
likely	kill, harm, hurt, injure, hit, affect, attack, be, cause, become
rape	rape, kill, hurt, attack, assault, injure, harm, murder, hit, abuse
stall	stall, delay, stop, impede, obstruct, pass, interrupt, slow, overtake, block
list	list, be, become, join, follow, notice, affect, add, include, cause
if	kill, hit, become, be, affect, injure, attack, eat, cause, hurt
hail	hit, kill, strike, harm, attack, injure, hail, hurt, wake, shoot
scale	affect, scale, effect, hit, increase, hurt, grow, move, exceed, impact
paint	paint, draw, color, affect, kill, hit, touch, create, animate, see
lay	lay, kill, hit, harm, lie, beat, touch, strike, injure, deceive
balloon	balloon, hurt, affect, injure, harm, hit, kill, exceed, eat, grow
unravel	break, destroy, kill, unravel, harm, affect, become, injure, hurt, corrupt
mate	mate, love, attract, marry, like, kill, become, match, be, date
fill	fill, replace, occupy, empty, cover, create, become, satisfy, eat, affect
rent	rent, own, evict, buy, hire, be, kill, sell, pay, become
vary	affect, be, change, influence, become, resemble, confuse, cause, contradict, effect
enjoy	enjoy, please, amuse, annoy, benefit, affect, pleasure, like, help, satisfy
fine	fine, hit, injure, hurt, kill, affect, bite, annoy, fry, harm
doubt	doubt, question, deceive, believe, contradict, mislead, trust, hurt, harm, distrust
cop	cop, kill, hit, hurt, harm, beat, bite, shoot, murder, injure
referee	referee, injure, fight, influence, beat, stop, defeat, dominate, hit, challenge
betray	betray, deceive, hurt, kill, trust, attack, tell, harm, destroy, mislead
host	host, provoke, invite, attract, welcome, offend, feed, visit, be, attack
scan	scan, see, attack, detect, kill, affect, read, touch, hit, eat
embrace	embrace, love, reject, overcome, hug, attract, accept, become, welcome, touch
home	hit, kill, injure, harm, hurt, strike, attack, affect, touch, destroy
protect	protect, harm, defend, attack, kill, hurt, injure, save, help, destroy
overlap	overlap, be, become, affect, influence, resemble, cross, follow, kill, contradict
dawn	wake, kill, awaken, deceive, affect, see, cause, destroy, disturb, overtake
good	harm, help, good, do, benefit, hurt, like, affect, cause, evil
Win	defeat, win, beat, kill, overcome, lose, fight, overtake, dominate, injure
decay	destroy, kill, harm, affect, become, corrupt, injure, hurt, consume, replace
that	be, do, cause, kill, affect, harm, become, hurt, injure, attack
reboot	reboot, restart, kill, crash, reset, interrupt, affect, replace, hit, attack
boast	insult, boast, offend, deceive, compliment, praise, congratulate, beat, injure, benefit
crawl	kill, eat, crawl, bite, hurt, touch, harm, injure, move, hit
man	kill, harm, injure, cause, affect, be, become, destroy, create, attack
receive	give, receive, send, cause, affect, produce, benefit, get, harm, help
conclude	conclude, cause, kill, follow, contradict, stop, affect, tell, persuade, answer
resume	kill, stop, revive, interrupt, restart, resume, restore, affect, replace, terminate
put	put, hit, take, make, kill, give, move, hurt, cause, get
blind	blind, see, hurt, kill, harm, affect, hit, injure, deceive, fool
resurrect	resurrect, revive, kill, become, save, destroy, replace, create, be, attack
flow	flow, affect, cause, create, move, influence, follow, become, effect, attract
farm	farm, kill, produce, eat, feed, hurt, harm, injure, be, control
defend	defend, attack, oppose, harm, injure, hurt, kill, protect, offend, threaten
all	cause, kill, affect, harm, hurt, all, injure, destroy, do, be
trump	trump, beat, defeat, overtake, win, overcome, play, dominate, influence, lead
her	kill, hurt, harm, cause, affect, be, injure, do, hit, help
he	kill, injure, harm, hurt, hit, attack, affect, be, cause, destroy
reproduce	reproduce, produce, affect, kill, become, infect, create, cause, attract, influence
riot	riot, provoke, attack, injure, kill, harm, hurt, hit, insult, fight
press	press, push, touch, harass, interrupt, attack, hit, hurt, kill, affect
skyrocket	increase, hurt, affect, harm, kill, be, hit, influence, help, become
breed	kill, breed, become, marry, reproduce, produce, infect, love, eat, destroy
echo	echo, imitate, interrupt, hear, mimic, follow, sound, affect, silence, wake
so	kill, harm, affect, hurt, injure, influence, cause, do, be, help
photograph	photograph, shoot, observe, see, provoke, picture, follow, capture, kill, film
face	face, hit, kill, see, attack, affect, strike, hurt, touch, harm
recoil	hit, hurt, provoke, touch, attack, harm, strike, kill, shock, shoot
bowl	bowl, hit, affect, knock, throw, squash, toss, effect, strike, stop
arrest	arrest, detain, stop, apprehend, attack, hurt, injure, harm, kill, provoke
stare	stare, notice, see, observe, watch, touch, hit, question, approach, provoke
unite	unite, cause, join, overcome, destroy, help, affect, become, influence, kill
trust	trust, believe, like, deceive, help, love, know, hurt, respect, convince
drift	influence, move, affect, follow, attract, cause, hit, wake, harm, drive
tread	cross, hit, touch, strike, hurt, injure, kill, follow, harm, move
gasp	scare, touch, hit, choke, gasp, shock, kill, hurt, surprise, wake
spell	spell, write, say, make, read, tell, correct, pronounce, copy, affect
beam	beam, hit, affect, harm, see, distract, attract, hurt, illuminate, touch
beware	warn, scare, kill, deceive, beware, harm, avoid, fear, hurt, attack
mobilize	mobilize, activate, provoke, attack, motivate, rally, engage, move, help, attract
no	kill, no, stop, affect, do, reject, hit, harm, hurt, strike
bring	bring, cause, kill, produce, make, create, destroy, harm, attack, hurt
curl	curl, hurt, hit, touch, bite, injure, choke, poke, affect, make
fuse	fuse, hurt, injure, destroy, affect, kill, attract, harm, hit, cause
wins	kill, beat, defeat, injure, hurt, hit, help, harm, overcome, affect
scoff	insult, offend, mock, annoy, ridicule, criticize, provoke, hit, taunt, upset
cum	cum, fuck, hurt, drive, hit, make, kill, stimulate, orgasm, attract
clear	clear, see, deceive, cross, correct, wake, confuse, pass, distract, hit
trigger	trigger, cause, provoke, hit, affect, activate, kill, hurt, prompt, invoke
hike	hike, kill, push, hit, see, help, attack, injure, move, hurt
hell	kill, hurt, destroy, harm, hit, injure, hate, fuck, attack, murder
chip	chip, hit, bite, attack, kill, eat, hurt, move, break, knock
verify	verify, deceive, confirm, contradict, believe, trust, doubt, tell, be, validate
shake	shake, hit, touch, move, hurt, strike, wake, knock, affect, kick
once	kill, hit, be, become, injure, affect, cause, hurt, attack, stop
reason	reason, cause, understand, persuade, influence, think, correct, tell, convince, confuse
twitch	touch, twitch, move, wake, hit, hurt, affect, bite, poke, pinch
applaud	applaud, cheer, encourage, congratulate, insult, correct, salute, provoke, thank, praise
operate	control, affect, influence, cause, obey, effect, activate, operate, kill, do
solo	kill, hit, injure, hurt, affect, harm, attack, touch, bite, stop
self	self, kill, harm, become, affect, be, cause, possess, injure, make
integrate	integrate, attract, affect, become, join, replace, influence, understand, resemble, overcome
perhaps	kill, affect, harm, injure, cause, be, become, hit, hurt, influence
teleport	teleport, kill, touch, attack, hit, harm, see, move, become, follow
convince	convince, persuade, deceive, convert, defeat, believe, influence, overcome, fool, mislead
record	record, hear, tell, affect, write, create, interrupt, copy, produce, call
sound	sound, hear, say, imitate, be, call, make, affect, hit, echo
upgrade	upgrade, replace, update, improve, change, help, affect, benefit, kill, beat
this	harm, cause, be, kill, affect, hurt, injure, do, hit, become
life	kill, harm, become, save, cause, injure, create, affect, be, hurt
baby	kill, hurt, injure, harm, hit, affect, attack, cause, destroy, touch
shower	shower, wake, water, hit, touch, wash, kiss, bath, fuck, kill
wind	wind, blow, kill, affect, touch, hit, strike, harm, fly, hurt
pack	pack, eat, move, hurt, kill, hit, injure, harm, push, attack
however	affect, kill, become, harm, cause, influence, effect, hit, be, overcome
tip	tip, hit, touch, push, flip, drop, hurt, move, spin, trip
project	project, affect, attract, cause, produce, create, provoke, effect, influence, manifest
anyways	kill, harm, hurt, injure, hit, affect, cause, attack, stop, destroy
repay	repay, owe, pay, forgive, help, harm, do, hurt, serve, save
sob	hurt, cry, harm, touch, hit, affect, upset, sob, kill, comfort
reject	reject, refuse, exclude, offend, deny, refute, oppose, contradict, accept, persuade
duck	duck, hit, shoot, avoid, punch, dodge, attack, pass, touch, see
broadcast	broadcast, transmit, emit, tell, hear, inform, affect, deceive, notify, call
delay	delay, stop, interrupt, slow, postpone, kill, avoid, obstruct, prevent, prompt
inform	inform, notify, tell, deceive, influence, warn, affect, instruct, advise, alert
slice	slice, cut, eat, bite, kill, stab, slash, injure, consume, hit
communicate	communicate, understand, influence, affect, contact, cause, tell, hear, see, help
copy	copy, imitate, duplicate, emulate, clone, reproduce, modify, resemble, edit, influence
hand	hit, touch, kill, strike, shoot, injure, produce, hand, attack, grab
mature	influence, affect, change, become, mature, resemble, kill, love, hurt, be
contend	injure, fight, overcome, challenge, beat, harm, provoke, kill, defeat, threaten
wed	wed, marry, love, kill, become, meet, kiss, date, hurt, divorce
stray	harm, follow, hurt, injure, cross, hit, provoke, kill, influence, attack
dress	dress, affect, be, resemble, wear, influence, effect, see, touch, make
observe	observe, affect, see, influence, notice, watch, effect, cause, provoke, follow
peak	peak, affect, increase, hit, exceed, overtake, hurt, harm, surpass, stimulate
deny	deny, refute, contradict, affirm, question, oppose, challenge, believe, deceive, reject
compare	compare, beat, compliment, resemble, equal, improve, match, be, affect, rival
storm	storm, hit, destroy, attack, threaten, strike, hurt, injure, harm, damage
restore	restore, destroy, affect, harm, revive, injure, heal, kill, save, repair
restart	restart, stop, kill, reboot, interrupt, start, revive, save, crash, reset
charm	charm, attract, affect, kiss, like, touch, woo, love, resemble, hurt
stone	kill, hit, stone, hurt, destroy, injure, harm, strike, attack, break
code	code, tell, write, cause, affect, program, break, create, bug, execute
deflect	deflect, distract, provoke, hit, divert, attack, deceive, annoy, redirect, affect
won	kill, hurt, harm, injure, hit, affect, attack, help, destroy, influence
tumble	hit, knock, topple, drop, trip, throw, strike, touch, push, move
feature	affect, resemble, feature, become, be, influence, attract, cause, kill, include
appreciate	appreciate, love, like, help, understand, please, compliment, affect, hurt, benefit
time	kill, cause, affect, hurt, stop, hit, delay, injure, harm, influence
fare	harm, injure, hurt, affect, help, fare, benefit, kill, cause, eat
else	affect, be, become, kill, cause, do, injure, have, attack, hurt
dictate	dictate, influence, control, cause, change, govern, command, affect, obey, direct
cause	cause, affect, kill, effect, harm, influence, do, create, hurt, make
depend	affect, influence, change, effect, be, become, satisfy, obey, cause, contradict
what	kill, cause, affect, injure, harm, hurt, hit, be, attack, do
fumble	fumble, hit, touch, move, hurt, kick, push, injure, confuse, strike
hover	hover, touch, hit, fly, influence, affect, avoid, move, kill, control
hug	hug, touch, kiss, grab, hit, embrace, punch, hurt, bite, slap
harvest	harvest, produce, eat, kill, consume, harm, reap, hurt, hit, feed
piss	piss, hit, pee, fuck, kill, wet, touch, shit, affect, annoy
abort	abort, kill, harm, terminate, affect, hurt, injure, produce, destroy, infect
space	move, space, affect, orbit, be, hit, hurt, create, touch, cause
orbit	orbit, hit, influence, affect, move, touch, kill, avoid, impact, destroy
brew	brew, affect, make, produce, cause, drink, create, influence, infect, kill
supply	supply, produce, provide, give, feed, serve, satisfy, consume, require, cause
rescue	rescue, save, help, aid, kill, assist, hurt, attack, revive, get
compute	compute, affect, cause, calculate, tell, be, do, satisfy, move, process
on	affect, kill, hit, hurt, on, stop, cause, destroy, harm, wake
allow	allow, deny, prevent, stop, kill, let, cause, harm, permit, impede
frown	frown, annoy, offend, touch, hit, upset, curse, criticize, hurt, affect
rewrite	rewrite, change, affect, modify, alter, write, overwrite, copy, influence, make
engage	engage, provoke, attack, affect, attract, influence, harm, involve, injure, approach
divorce	divorce, marry, hurt, harm, kill, leave, injure, destroy, love, become
defeat	defeat, beat, overcome, kill, destroy, fight, injure, attack, lose, harm
fear	fear, scare, threaten, harm, hurt, intimidate, kill, attack, affect, injure
often	affect, injure, kill, hurt, harm, hit, annoy, like, offend, attack
impress	impress, attract, please, like, influence, annoy, resemble, affect, insult, compliment
yes	kill, affect, obey, become, stop, do, follow, cause, be, like
OK	kill, stop, affect, hurt, harm, obey, help, attack, hit, like
name	name, be, call, become, identify, describe, know, rename, kill, cause
delete	delete, remove, copy, erase, edit, kill, add, notify, create, destroy
strip	strip, touch, hit, strike, pinch, hurt, kick, remove, injure, slap
both	kill, cause, affect, injure, harm, hurt, do, hit, be, attack
boil	boil, burn, kill, affect, heat, cook, melt, fry, drown, hurt
lift	lift, move, hit, push, drop, help, lower, raise, elevate, touch
moan	moan, annoy, wake, hurt, affect, hit, insult, offend, kiss, upset
summarize	affect, kill, become, be, cause, follow, stop, influence, describe, injure
weld	weld, hurt, kill, break, injure, hit, affect, make, bind, destroy
challenge	challenge, provoke, attack, threaten, question, intimidate, affect, oppose, resist, confront
review	affect, attack, kill, stop, review, harm, provoke, destroy, follow, see
pretend	deceive, pretend, be, imitate, see, tell, trick, become, believe, fool
down	hit, kill, knock, affect, move, strike, hurt, harm, down, drop
achieve	achieve, cause, affect, help, influence, accomplish, assist, prevent, effect, do
request	request, ask, require, desire, want, cause, receive, please, help, need
long	delay, shorten, stop, slow, kill, long, follow, eat, be, bite
thing	affect, cause, do, be, become, create, make, hurt, kill, influence
succeeded	kill, harm, hurt, injure, affect, hit, be, attack, become, cause
rush	rush, delay, push, accelerate, stop, hit, pass, kill, beat, hurry
flock	attract, kill, attack, annoy, follow, avoid, harass, eat, harm, fear
homer	hit, hurt, kill, injure, harm, strike, attack, affect, bite, eat
by	kill, harm, injure, affect, pass, hit, be, attack, destroy, become
weigh	weigh, weight, eat, outweigh, affect, consume, measure, kill, move, lift
defect	kill, deceive, harm, betray, injure, defect, influence, hurt, destroy, affect
party	party, affect, entertain, hurt, harm, influence, hit, provoke, kill, effect
distract	distract, interrupt, annoy, disturb, affect, confuse, attract, influence, provoke, divert
cool	cool, annoy, chill, kill, affect, hurt, cooler, touch, like, heat
recruit	recruit, attract, hire, kill, attack, provoke, help, influence, induce, defeat
sniff	sniff, smell, touch, bite, hit, kiss, lick, hurt, annoy, kick
align	influence, affect, cause, move, follow, help, correct, be, effect, attract
immediately	kill, affect, harm, hurt, injure, cause, hit, attack, stop, destroy
fret	upset, worry, fret, affect, hurt, alarm, annoy, injure, disturb, harm
empty	empty, fill, become, create, occupy, contain, void, replace, be, consume
transition	become, change, affect, replace, be, transition, move, kill, convert, influence
infect	infect, kill, attack, infected, harm, eat, attract, affect, enter, cause
day	kill, hurt, affect, cause, injure, harm, stop, destroy, be, hit
itch	itch, scratch, touch, bite, hurt, pinch, hit, sting, annoy, affect
forfeit	forfeit, lose, defeat, injure, beat, cheat, hit, kill, strike, hurt
sense	sense, perceive, see, detect, understand, know, hear, recognize, confuse, notice
evacuate	evacuate, attack, kill, harm, hit, injure, threaten, hurt, save, escape
top	top, beat, overtake, pass, surpass, follow, defeat, exceed, dominate, succeed
them	kill, cause, harm, hurt, affect, injure, be, do, hit, become
demand	demand, ask, require, satisfy, request, want, give, refuse, produce, desire
pretty	affect, kill, hurt, attract, hit, like, resemble, injure, harm, annoy
cap	kill, hit, hurt, cap, injure, stop, attack, affect, control, eat
abide	obey, offend, harm, abide, follow, violate, stop, hurt, affect, kill
girl	kill, hurt, harm, injure, hit, affect, attack, cause, destroy, be
nest	kill, eat, marry, nest, annoy, attract, destroy, feed, infect, attack
commute	commute, disturb, affect, delay, move, transport, annoy, attract, kill, follow
key	key, affect, kill, attack, control, wake, see, hear, interrupt, copy
BE	be, affect, become, attack, kill, cause, effect, harm, create, stop
patrol	kill, harm, injure, hit, attack, hurt, affect, touch, strike, stop
create	create, cause, make, destroy, affect, produce, kill, effect, become, change
hopefully	kill, hurt, harm, injure, hit, affect, attack, cause, influence, destroy
shock	shock, surprise, hurt, kill, affect, hit, stun, wake, touch, upset
seem	be, become, resemble, seem, see, affect, appear, perceive, cause, like
present	present, become, affect, cause, produce, be, create, attract, influence, see
capitalize	overtake, capitalize, attract, benefit, affect, kill, influence, effect, become, attack
file	file, fire, affect, delete, be, exhaust, create, produce, execute, write
guard	guard, attack, protect, defend, kill, harm, stop, threaten, injure, hurt
am	kill, hurt, harm, injure, hit, affect, attack, cause, be, destroy
solve	solve, help, cause, answer, affect, kill, puzzle, hit, fix, satisfy
just	kill, hurt, cause, injure, affect, harm, be, upset, help, become
we	kill, injure, harm, hurt, affect, be, hit, become, cause, attack
head	hit, kill, head, injure, hurt, kick, bite, harm, beat, attack
breakdown	break, destroy, hurt, injure, harm, affect, kill, hit, damage, attack
drip	drip, touch, drop, affect, kill, wet, hurt, feed, bleed, hit
off	hit, kill, affect, bite, touch, off, hurt, stop, annoy, upset
discriminate	discriminate, harm, offend, hate, hurt, prejudice, exclude, dislike, be, affect
accelerate	accelerate, stop, slow, kill, affect, cause, delay, hit, hurt, overtake
chew	chew, bite, eat, swallow, hurt, hit, kill, attack, choke, touch
invest	invest, attract, benefit, buy, interest, affect, influence, help, own, reward
bullshit	bullshit, fuck, mislead, annoy, insult, hit, deceive, kill, convince, confuse
spend	pay, spend, buy, cost, give, benefit, charge, help, harm, cause
spin	spin, hit, affect, move, influence, turn, bend, hurt, drive, kick
flash	flash, touch, affect, hit, see, burn, attack, stun, shoot, strike
God	kill, harm, destroy, be, god, become, hurt, cause, worship, injure
mount	mount, attack, climb, hit, kill, shoot, ride, overpower, injure, charge
snowball	snowball, hit, affect, hurt, kill, bully, punch, influence, attack, harm
jog	jog, hit, move, injure, pass, run, kick, follow, hurt, stop
compromise	deceive, compromise, hurt, harm, kill, offend, persuade, betray, help, threaten
alone	be, kill, become, hurt, injure, harm, affect, separate, cause, attack
Fail	fail, affect, kill, defeat, hit, injure, become, harm, be, hurt
retract	correct, contradict, attack, retract, bite, threaten, refute, insult, deceive, interrupt
collide	hit, impact, strike, kill, touch, injure, hurt, affect, harm, destroy
foul	foul, hurt, harm, injure, offend, attack, hit, provoke, annoy, touch
freelance	kill, injure, harm, affect, hurt, become, influence, be, help, attack
wolf	kill, attack, bite, eat, hit, harm, hurt, affect, injure, be
guarantee	injure, kill, harm, affect, be, cause, destroy, guarantee, prevent, hurt
repeal	affect, kill, repeal, harm, effect, change, destroy, cause, remove, replace
misunderstand	misunderstand, confuse, understand, misinterpret, offend, mislead, deceive, insult, correct, hurt
taste	taste, affect, eat, touch, smell, bite, flavor, hurt, offend, make
address	address, affect, answer, attack, correct, provoke, attract, cause, ignore, hit
sway	sway, influence, move, affect, change, persuade, hurt, control, harm, favor
repair	repair, injure, damage, fix, heal, hurt, harm, break, affect, destroy
wrong	correct, wrong, hurt, harm, injure, hit, offend, affect, do, misunderstand
campaign	influence, defeat, attack, affect, persuade, oppose, motivate, help, elect, support
to	kill, affect, harm, hurt, cause, hit, injure, influence, attack, do
anchor	anchor, attract, affect, attack, influence, break, move, impact, provoke, hit
venture	harm, injure, provoke, kill, overcome, cause, enter, attract, touch, pursue
definitely	kill, hurt, harm, injure, hit, affect, attack, cause, influence, destroy
renew	renew, become, replace, revive, kill, refresh, change, create, be, retain
download	download, copy, update, get, attract, affect, be, like, abuse, become
even	equal, attract, kill, affect, become, like, hit, be, make, cross
derail	derail, hit, cause, affect, stop, injure, harm, hurt, kill, impact
vacuum	vacuum, kill, consume, hit, eat, destroy, move, expel, wake, swallow
answers	kill, hurt, harm, affect, hit, injure, cause, attack, influence, help
contract	contract, hurt, kill, injure, bite, affect, become, attract, touch, change
phone	call, phone, telephone, text, contact, tell, reach, answer, dial, be
rethink	change, influence, surprise, confuse, affect, misunderstand, think, provoke, question, alter
unfold	affect, cause, influence, become, be, effect, change, create, provoke, follow
bike	hit, bike, injure, kill, pass, ride, bicycle, overtake, attack, hurt
chat	chat, call, text, talk, tell, interrupt, ask, annoy, hear, disturb
steer	steer, hit, overtake, pass, avoid, influence, move, drive, kill, cause
coin	coin, kill, affect, attract, attack, hit, strike, change, create, produce
recharge	recharge, charge, revive, activate, refresh, kill, affect, reset, attack, hit
two	kill, hit, affect, cause, injure, hurt, harm, attack, be, two
abound	be, become, contradict, offend, provoke, kill, create, resemble, overcome, affect
manifest	manifest, become, be, affect, produce, create, cause, attract, kill, change
worsen	affect, worsen, harm, hurt, injure, improve, help, cause, change, influence
piece	hit, bite, piece, break, cut, injure, destroy, hurt, fragment, separate
school	kill, teach, harm, hurt, stop, bully, influence, injure, attack, offend
reopen	reopen, open, close, shut, attack, kill, enter, harm, wake, hit
enough	kill, hurt, hit, injure, harm, affect, attack, stop, cause, be
Posted	kill, hurt, injure, harm, hit, affect, attack, influence, cause, destroy
DJ	dj, kill, harm, control, interrupt, hit, disrupt, do, beat, affect
migrate	kill, move, become, replace, follow, influence, affect, relocate, attract, migrate
way	cause, influence, affect, move, touch, do, hurt, strike, be, harm
torture	torture, hurt, injure, kill, attack, abuse, harm, torment, murder, punish
invite	invite, exclude, provoke, attract, ask, welcome, avoid, offend, include, invitation
crest	kill, hit, hurt, injure, harm, affect, attack, touch, destroy, influence
define	define, cause, become, be, create, affect, describe, make, change, influence
WIN	defeat, beat, win, ko, lose, overcome, kill, fight, hit, overtake
disband	destroy, disband, kill, harm, become, defeat, join, replace, attack, separate
surely	kill, hurt, harm, injure, hit, affect, attack, influence, destroy, touch
survived	kill, harm, hurt, injure, hit, affect, attack, destroy, cause, be
license	license, harm, kill, offend, become, injure, be, affect, control, please
there	kill, be, cause, affect, harm, become, hurt, hit, injure, attack
year	kill, injure, hurt, harm, affect, cause, hit, be, influence, destroy
pale	harm, kill, resemble, hurt, affect, injure, pale, be, see, touch
OD	kill, harm, hurt, affect, infect, injure, od, attack, stop, cause
advise	advise, instruct, persuade, influence, inform, advice, tell, counsel, warn, help
Survive	kill, harm, hurt, injure, hit, affect, attack, destroy, cause, influence
consider	affect, consider, cause, think, influence, provoke, stop, notice, effect, deceive
type	type, write, copy, tell, read, prompt, hit, create, text, use
separate	separate, affect, become, hurt, harm, kill, injure, destroy, be, cause
skip	skip, miss, pass, delay, interrupt, follow, jump, kill, stop, hit
drag	drag, move, hit, hurt, push, kick, follow, injure, touch, lift
spot	spot, see, notice, detect, miss, hit, recognize, identify, attract, smell
sunset	kill, hit, strike, sunset, destroy, affect, harm, injure, stop, hurt
most	cause, affect, harm, kill, hurt, injure, hit, most, influence, offend
reside	become, be, affect, cause, create, kill, inhabit, possess, harm, influence
expect	expect, be, surprise, please, cause, anticipate, like, want, do, affect
college	kill, injure, hurt, harm, influence, cause, affect, be, become, help
order	order, obey, control, affect, cause, follow, command, produce, please, effect
lock	lock, unlock, break, hit, hurt, choke, bind, hold, move, kill
rear	rear, hit, strike, attack, provoke, injure, hurt, touch, approach, see
quote	quote, contradict, interrupt, cite, read, copy, imitate, offend, follow, say
interview	interview, harass, interrupt, hire, attack, provoke, kill, quote, approach, question
away	harm, hurt, kill, attack, hit, injure, affect, leave, become, be
son	kill, hurt, harm, injure, hit, affect, attack, cause, destroy, influence
bald	kill, hurt, injure, harm, hit, affect, attack, touch, destroy, bite
might	cause, affect, do, like, influence, kill, hurt, help, make, please
stitch	stitch, knit, sew, touch, hurt, affect, cause, make, stab, injure
stump	hit, stump, injure, hurt, kill, strike, harm, attack, slap, bite
course	cause, affect, influence, correct, kill, follow, effect, provoke, control, course
over	kill, hit, over, overcome, affect, injure, hurt, overtake, cross, influence
Cry	kill, hurt, harm, injure, hit, affect, attack, touch, destroy, stop
she	kill, injure, harm, hurt, affect, hit, attack, be, cause, become
grace	grace, offend, kill, help, harm, injure, affect, provoke, please, save
swoop	attack, swoop, kill, strike, fly, hit, catch, swat, harm, sting
support	support, oppose, help, kill, influence, assist, hate, attack, hurt, harm
lecture	lecture, teach, interrupt, instruct, correct, tell, insult, offend, provoke, stop
debate	debate, offend, question, influence, provoke, insult, criticize, contradict, challenge, upset
reap	reap, benefit, produce, harm, eat, sow, harvest, favor, kill, affect
themselves	harm, kill, cause, injure, hurt, affect, attack, destroy, hit, do
stew	eat, kill, affect, harm, hurt, consume, hate, bother, offend, destroy
trade	trade, buy, sell, harm, pay, kill, influence, be, acquire, hurt
known	kill, affect, harm, be, injure, become, cause, know, hurt, destroy
dot	dot, affect, hit, attract, kill, be, follow, move, become, resemble
malfunction	affect, malfunction, harm, kill, damage, hurt, fail, injure, disable, break
lack	lack, need, be, produce, lose, replace, become, have, possess, affect
avail	kill, injure, harm, affect, help, cause, hurt, attack, stop, destroy
yawn	yawn, wake, kiss, annoy, bite, hurt, eat, disturb, touch, see
consent	touch, control, kill, rape, hurt, violate, harm, be, consent, influence
brawl	fight, punch, hit, attack, hurt, injure, beat, brawl, harm, strike
reflect	reflect, affect, change, influence, effect, correct, mirror, contradict, resemble, distort
pursue	pursue, follow, attract, affect, influence, chase, encourage, lead, cause, motivate
proof	kill, harm, affect, hurt, injure, cause, attack, hit, destroy, be
speed	speed, accelerate, slow, kill, pass, hit, stop, delay, overtake, affect
place	affect, cause, move, hit, kill, effect, place, follow, injure, harm
sketch	sketch, draw, provoke, paint, create, write, see, injure, animate, resemble
quickly	kill, harm, attack, stop, injure, delay, follow, hit, hurt, affect
plot	plot, cause, kill, affect, attack, follow, animate, influence, control, be
trick	trick, fool, deceive, hurt, cheat, manipulate, influence, help, hit, tricks
invade	invade, attack, kill, destroy, conquer, occupy, harm, enter, injure, hurt
gamble	bribe, hit, kill, hurt, lose, cheat, injure, influence, harm, threaten
determine	determine, cause, affect, influence, kill, become, control, tell, be, create
coast	kill, hit, overtake, injure, attack, harm, cause, cross, hurt, benefit
latch	latch, attract, bite, grab, catch, hit, touch, feed, distract, hurt
gel	gel, kill, affect, become, harm, deform, infect, hurt, injure, attract
stroke	stroke, injure, strike, hit, hurt, touch, kill, attack, harm, move
opt	choose, elect, kill, opt, select, persuade, influence, be, become, affect
brain	affect, kill, hit, brain, hurt, injure, harm, bite, wake, attack
eclipse	eclipse, affect, influence, see, overcome, destroy, pass, overtake, be, harm
sour	sour, hurt, affect, kill, harm, annoy, hit, offend, eat, injure
badly	injure, harm, hurt, hit, kill, attack, affect, damage, insult, bite
perfect	perfect, improve, make, imitate, become, help, change, please, correct, satisfy
loot	loot, kill, steal, rob, attack, hurt, hit, harm, shoot, bribe
mix	mix, affect, become, confuse, kill, influence, create, be, cause, make
shovel	shovel, kill, hit, shove, throw, eat, hurt, push, move, attack
parent	parent, produce, kill, love, influence, affect, become, control, teach, be
elect	elect, choose, influence, become, defeat, affect, replace, select, control, be
zero	zero, equal, kill, stop, affect, be, destroy, hit, cancel, negate
rocket	rocket, hit, kill, shoot, hurt, attack, accelerate, explode, harm, jump
filibuster	filibuster, interrupt, stop, silence, attack, oppose, delay, obstruct, strike, kill
shred	shred, destroy, kill, break, injure, cut, hurt, rip, harm, attack
expose	expose, reveal, inform, tell, destroy, see, find, provoke, affect, discover
reconnect	contact, touch, reconnect, become, affect, connect, see, love, hurt, help
nail	nail, hit, kill, injure, hurt, strike, bite, attack, knock, shoot
s	kill, injure, affect, harm, hurt, hit, cause, be, attack, stop
ignite	ignite, burn, touch, fire, spark, cause, affect, kill, attack, destroy
mail	mail, send, email, write, receive, notify, tell, address, call, hit
dispute	dispute, injure, contradict, offend, hurt, question, annoy, correct, insult, harm
circulate	become, influence, be, infect, circulate, kill, affect, produce, attract, create
dust	hit, dust, strike, destroy, kill, touch, injure, hurt, harm, move
size	size, weigh, grow, affect, injure, eat, hurt, enlarge, shrink, hit
mushroom	mushroom, eat, hurt, hit, grow, consume, kill, affect, attack, be
dwell	kill, affect, occupy, disturb, harm, destroy, follow, cause, become, provoke
Skype	skype, call, email, text, contact, phone, telephone, see, shoot, interrupt
sprint	hit, beat, stop, chase, pass, catch, kill, overtake, attack, injure
grate	offend, harm, injure, hurt, insult, annoy, kill, strike, grate, hit
override	override, obey, control, affect, overcome, kill, influence, contradict, be, overwrite
white	kill, white, be, affect, hit, overtake, hurt, injure, see, beat
fib	deceive, fib, mislead, tell, harm, cheat, distract, confuse, fool, annoy
mother	kill, injure, harm, hurt, hit, attack, affect, eat, destroy, produce
crow	crow, hit, annoy, attack, kill, hurt, strike, scare, harm, punch
weather	injure, affect, weather, harm, hit, kill, hurt, damage, attack, cause
harm	harm, injure, hurt, kill, attack, help, damage, hit, affect, threaten
reward	reward, punish, pay, benefit, give, repay, bribe, hurt, attract, obey
a	injure, kill, harm, hit, affect, attack, be, hurt, cause, stop
spew	spew, provoke, fire, spit, fart, affect, annoy, shoot, insult, hurt
revive	revive, resurrect, kill, save, regenerate, cure, become, restart, destroy, refresh
replace	replace, become, kill, remove, affect, destroy, change, be, substitute, follow
punt	hit, kick, punt, move, hurt, beat, strike, injure, punch, distract
blast	blast, hit, explode, kill, attack, destroy, shoot, hurt, bomb, affect
Live	kill, live, become, be, affect, cause, harm, save, create, help
scroll	scroll, follow, touch, move, affect, see, distract, read, kill, tell
provoke	provoke, incite, offend, cause, hurt, threaten, trigger, harm, injure, annoy
represent	represent, be, become, resemble, affect, create, replace, influence, describe, cause
slam	slam, hit, knock, punch, smash, strike, slap, bang, ram, smack
alert	alert, alarm, warn, notify, wake, hear, see, activate, awaken, notice
email	email, contact, call, mail, write, text, message, notify, tell, reply
red	hit, red, touch, burn, hurt, kill, attack, stop, see, harm
stack	stack, move, overtake, knock, hold, push, hit, affect, overcome, trump
spar	hit, fight, injure, hurt, punch, attack, strike, beat, kick, spar
fulfill	fulfill, satisfy, become, do, help, create, benefit, make, effect, please
desert	desert, kill, harm, leave, destroy, attack, hurt, abandon, eat, follow
pin	pin, hit, strike, touch, affect, pinch, attack, injure, hurt, poke
father	father, kill, produce, parent, destroy, become, harm, create, love, beat
track	track, follow, chase, move, stalk, pursue, attract, hit, beat, evade
job	kill, hurt, harm, injure, hit, affect, attack, cause, destroy, touch
ensure	kill, injure, cause, prevent, harm, affect, destroy, be, stop, hurt
innovate	innovate, influence, change, improve, help, affect, benefit, inspire, create, invent
late	kill, injure, hit, hurt, harm, attack, affect, beat, eat, stop
flag	flag, warn, detect, alert, see, notify, deceive, alarm, touch, notice
sober	harm, kill, affect, sober, injure, drink, hurt, wake, stop, consume
zip	zip, shoot, hit, annoy, jump, fly, follow, punch, stop, kill
fuel	fuel, ignite, exhaust, cause, kill, accelerate, feed, fire, attract, refuel
heat	heat, warm, burn, cool, touch, melt, affect, fire, hurt, kill
acknowledge	acknowledge, recognize, see, notice, touch, know, correct, affect, understand, notify
troll	troll, harass, bully, taunt, insult, trolls, abuse, provoke, tweet, threaten
heart	hurt, love, affect, kill, hate, touch, harm, hit, strike, offend
gather	gather, attract, attack, surround, follow, join, meet, produce, provoke, kill
negotiate	threaten, persuade, negotiate, bribe, influence, kill, help, provoke, pay, harm
gold	kill, injure, harm, hurt, affect, hit, attack, destroy, beat, stop
maintain	maintain, destroy, kill, change, affect, harm, injure, keep, break, lose
tattoo	tattoo, kill, hurt, injure, bite, touch, harm, affect, attack, resemble
revise	revise, change, affect, alter, correct, influence, modify, contradict, copy, provoke
brake	hit, brake, stop, pass, overtake, strike, accelerate, block, impact, slow
activate	activate, affect, trigger, kill, control, attack, effect, invoke, influence, disable
parachute	hit, parachute, jump, kill, strike, attack, drop, shoot, catch, hurt
second	kill, hit, injure, affect, attack, harm, hurt, destroy, follow, beat
lost	lose, kill, defeat, injure, hurt, destroy, be, hit, harm, affect
sample	affect, sample, provoke, effect, produce, stimulate, eat, attract, suppress, harm
ultimately	kill, harm, hurt, injure, affect, hit, cause, attack, destroy, influence
surf	surf, hit, beat, affect, kick, ride, wake, fish, drown, effect
sometimes	kill, affect, hurt, hit, injure, cause, harm, be, do, become
exercise	exercise, affect, exert, injure, move, use, control, obey, influence, do
easily	kill, injure, hit, hurt, harm, attack, affect, touch, control, beat
honor	honor, respect, hurt, kill, offend, please, harm, honour, insult, favor
Sunday	kill, hurt, injure, harm, hit, affect, attack, cause, influence, destroy
include	include, exclude, be, become, add, replace, affect, kill, remove, eliminate
tackle	tackle, hit, attack, affect, overcome, impact, kill, stop, challenge, approach
cruise	kill, affect, hit, injure, provoke, attack, harm, cause, hurt, overtake
sir	kill, hurt, harm, injure, hit, affect, attack, cause, destroy, influence
single	kill, become, injure, affect, hit, be, hurt, attract, harm, lose
at	kill, hit, hurt, harm, injure, affect, attack, cause, destroy, touch
Be	kill, harm, hurt, injure, affect, hit, be, cause, attack, destroy
ID	id, identify, kill, recognize, see, be, become, attack, know, attract
ready	kill, hurt, harm, hit, injure, affect, attack, cause, touch, stop
blank	kill, hit, affect, stop, attack, hurt, be, provoke, see, harm
redirect	redirect, influence, cause, affect, follow, direct, attract, hit, stop, confuse
yellow	yellow, touch, affect, burn, attack, harm, color, kill, damage, see
none	kill, cause, injure, harm, affect, be, destroy, hurt, hit, strike
earn	earn, pay, benefit, produce, make, help, reward, affect, get, influence
illustrate	affect, injure, cause, produce, influence, attract, be, provoke, animate, resemble
recommend	recommend, advise, like, influence, help, persuade, promote, suggest, harm, tell
inevitably	kill, harm, hurt, injure, hit, affect, attack, influence, cause, destroy
converge	follow, become, converge, cause, be, affect, influence, move, attract, intersect
dive	hit, kill, dive, drown, attack, drop, sink, hurt, eat, throw
wit	wit, injure, kill, harm, offend, beat, hurt, hit, bite, insult
soul	kill, hurt, harm, injure, hit, affect, attack, destroy, touch, cause
rake	rake, hit, strike, scratch, attack, hurt, bite, wake, claw, abuse
sag	sag, move, hit, deform, hurt, pinch, affect, harm, injure, bite
approach	approach, touch, attack, hit, encounter, avoid, follow, affect, stop, attract
influence	influence, affect, effect, control, change, cause, impact, persuade, manipulate, help
Miss	kill, hurt, injure, harm, hit, affect, attack, touch, influence, destroy
park	hit, park, stop, pass, follow, block, drive, overtake, kill, move
trace	trace, track, follow, attract, find, cause, see, move, detect, touch
ha	kill, hurt, harm, injure, hit, affect, attack, influence, cause, destroy
await	kill, injure, harm, stop, affect, cause, attack, be, delay, hurt
jar	jar, hurt, hit, harm, affect, injure, kill, provoke, sting, disturb
gone	kill, harm, hurt, injure, hit, affect, attack, cause, destroy, be
document	document, produce, cause, create, write, affect, describe, destroy, harm, provoke
grab	grab, touch, catch, bite, hit, attack, get, strike, grasp, punch
partake	consume, harm, offend, eat, influence, affect, benefit, possess, cause, kill
disconnect	disconnect, harm, affect, hurt, contact, lose, call, disturb, distract, interrupt
literally	hit, kill, affect, harm, hurt, injure, be, attack, become, stop
flirt	kiss, touch, flirt, annoy, like, provoke, hit, insult, harass, attract
surpass	surpass, overtake, defeat, exceed, beat, overcome, pass, succeed, outweigh, injure
guide	guide, influence, follow, control, direct, instruct, assist, cause, affect, mislead
Wed	kill, hurt, harm, injure, hit, affect, attack, influence, touch, cause
delegate	delegate, obey, control, override, command, refuse, influence, bribe, give, deny
deserve	deserve, injure, get, cause, give, benefit, hurt, kill, harm, be
commence	kill, stop, interrupt, cause, start, harm, begin, initiate, commence, destroy
Google	google, find, follow, copy, like, see, tell, ask, search, visit
entertain	entertain, amuse, annoy, attract, provoke, affect, distract, disturb, please, impress
wanna	kill, hurt, harm, hit, injure, affect, attack, cause, touch, influence
cast	cast, hit, throw, strike, harm, touch, kill, punch, affect, kick
accomplish	accomplish, do, cause, help, affect, achieve, assist, effect, prevent, influence
persuade	persuade, convince, deceive, influence, please, convert, help, attract, affect, change
chant	chant, taunt, provoke, call, disturb, annoy, interrupt, hear, cheer, curse
govern	govern, control, rule, influence, obey, command, affect, dominate, oppress, cause
diminish	diminish, affect, harm, become, injure, be, outweigh, destroy, hurt, reduce
unveil	kill, affect, destroy, attract, reveal, become, be, awaken, attack, cause
bottle	bottle, hurt, provoke, injure, hit, kill, shoot, affect, harm, offend
interpret	interpret, confuse, influence, affect, understand, cause, tell, teach, instruct, deceive
sustain	sustain, kill, destroy, harm, affect, injure, survive, support, create, cause
draft	draft, provoke, injure, affect, kill, attack, copy, wake, produce, create
educate	educate, teach, influence, instruct, inform, help, understand, affect, correct, harm
counter	counter, attack, hit, answer, provoke, refute, beat, correct, fight, stop
bind	bind, touch, hurt, bound, hold, tie, affect, hit, injure, restrain
warn	warn, alert, alarm, scare, tell, harm, threaten, kill, notify, deceive
narrow	narrow, shrink, widen, enlarge, be, become, define, cross, separate, affect
explore	explore, provoke, affect, cause, follow, stimulate, influence, attract, discover, pursue
calculate	calculate, compensate, affect, pay, compute, tell, cause, be, hit, equal
premiere	kill, affect, harm, hurt, injure, attack, cause, become, hit, destroy
seize	seize, take, possess, overtake, attack, control, grab, capture, command, kill
flame	burn, ignite, flame, fire, touch, light, strike, kill, consume, fuse
drone	kill, drone, hit, strike, attack, shoot, affect, harm, hurt, annoy
bat	hit, strike, catch, bat, drive, batter, kill, injure, beat, score
recite	recite, interrupt, teach, quote, provoke, stop, remind, tell, imitate, instruct
sooner	kill, hurt, harm, injure, hit, affect, attack, help, influence, cause
fruit	fruit, eat, produce, kill, harm, affect, hit, hurt, attract, bite
night	kill, wake, awaken, harm, affect, injure, hurt, strike, attack, disturb
bluff	bluff, trick, deceive, mislead, fool, provoke, hit, hurt, bribe, insult
bob	hit, bob, move, affect, hurt, bend, toss, wake, stun, injure
gag	gag, choke, bite, hurt, scare, eat, stop, hit, touch, harm
war	kill, attack, harm, destroy, injure, hurt, fight, defeat, strike, shoot
hint	hint, mislead, tell, warn, notice, notify, confuse, deceive, inform, alert
tick	tick, touch, affect, hit, hurt, kill, attract, be, annoy, move
creep	creep, kill, touch, attack, scare, see, move, be, disturb, deceive
detect	detect, see, notice, perceive, observe, confuse, sense, deceive, affect, recognize
consume	consume, eat, affect, produce, feed, influence, harm, cause, satisfy, effect
amend	amend, change, affect, alter, modify, correct, offend, influence, make, effect
disclose	disclose, tell, inform, deceive, reveal, mislead, notify, expose, betray, identify
detail	affect, injure, kill, cause, harm, hurt, provoke, follow, influence, resemble
bother	bother, annoy, disturb, hurt, harass, offend, affect, harm, touch, trouble
stress	stress, affect, hurt, upset, annoy, bother, touch, injure, influence, distress
LIVE	kill, affect, become, live, harm, be, injure, hurt, create, eat
flush	flush, touch, splash, hit, wet, kill, fart, flood, upset, smell
dim	dim, see, illuminate, harm, affect, kill, hurt, light, attract, hit
conflict	harm, affect, influence, hurt, attack, kill, offend, injure, annoy, contradict
rat	rat, kill, hit, bite, hurt, eat, beat, injure, attack, kick
lol	kill, hit, hurt, affect, injure, harm, attack, bite, annoy, stop
imagine	imagine, cause, see, affect, create, influence, be, perceive, become, describe
organize	organize, influence, cause, affect, control, attract, help, motivate, create, produce
bid	bid, buy, bribe, pay, benefit, offer, attack, win, bidder, match
ghost	ghost, kill, haunt, touch, become, be, see, harm, visit, affect
cancer	kill, harm, cancer, hurt, injure, eat, cure, attack, infect, affect
ice	freeze, ice, melt, kill, hit, injure, affect, hurt, eat, touch
Blink	affect, kill, attack, harm, hit, hurt, stop, injure, influence, see
rescind	harm, affect, offend, provoke, kill, rescind, contradict, effect, insult, injure
recycle	recycle, replace, produce, affect, use, eat, kill, attract, change, consume
erase	erase, destroy, kill, affect, create, remove, be, delete, overwrite, become
permanently	kill, harm, affect, injure, hurt, destroy, hit, damage, change, become
brother	kill, hurt, harm, injure, hit, affect, attack, destroy, cause, influence
avoid	avoid, kill, ignore, attract, evade, hit, help, provoke, prevent, attack
bill	bill, pay, charge, injure, cost, eat, affect, harm, owe, borrow
dock	dock, hit, discharge, injure, attack, harm, strike, attract, kill, throw
remove	remove, affect, replace, move, kill, create, exclude, attract, destroy, eliminate
NOT	affect, be, stop, not, kill, hurt, do, like, hit, cause
sort	sort, affect, separate, like, correct, help, make, modify, change, treat
suicide	kill, harm, hurt, injure, murder, cause, attack, affect, hit, destroy
roam	kill, chase, harm, follow, attack, attract, disturb, injure, hurt, hit
concentrate	distract, affect, influence, concentrate, stop, interrupt, confuse, help, disturb, hear
Saturday	kill, hurt, injure, harm, hit, affect, attack, cause, influence, destroy
bankrupt	bankrupt, harm, injure, fail, destroy, hurt, ruin, kill, be, affect
climax	kill, climax, affect, stop, destroy, effect, finish, harm, hurt, possess
yesterday	kill, injure, hurt, harm, affect, hit, influence, be, cause, attack
knit	knit, hit, kill, affect, hurt, touch, make, bind, stitch, injure
stabilize	stabilize, affect, control, move, help, influence, calm, support, change, kill
coincide	be, cause, affect, influence, become, follow, effect, resemble, kill, do
load	load, execute, redirect, follow, kill, hit, affect, reload, read, be
labor	labor, hurt, injure, kill, harm, produce, affect, work, employ, strike
soldier	kill, hurt, harm, injure, hit, attack, affect, destroy, cause, help
conceive	conceive, produce, cause, affect, create, become, reproduce, make, induce, be
truth	deceive, harm, believe, be, kill, affect, contradict, cause, mislead, correct
trumpet	trumpet, hit, harm, strike, hear, kill, attack, annoy, injure, insult
contest	defeat, beat, injure, challenge, fight, contest, attack, win, dominate, affect
purge	purge, consume, eat, destroy, kill, harm, expel, affect, hurt, remove
Pass	kill, harm, hurt, injure, hit, affect, attack, destroy, cause, be
ya	kill, hurt, injure, harm, hit, affect, attack, cause, destroy, influence
cake	kill, hurt, injure, harm, hit, affect, attack, cause, help, influence
revenge	kill, hurt, attack, hit, injure, harm, hate, punish, destroy, murder
screw	screw, fuck, hit, hurt, drive, fool, affect, damage, do, control
bump	bump, hit, smack, knock, push, punch, impact, hump, move, bang
absorb	absorb, affect, attract, hear, hurt, effect, distract, hit, consume, understand
upset	upset, affect, hurt, annoy, disturb, offend, injure, harm, threaten, provoke
truck	kill, hit, hurt, injure, harm, affect, attack, touch, stop, destroy
spare	spare, kill, save, injure, hurt, help, harm, be, get, strike
aid	aid, help, assist, harm, benefit, save, serve, hurt, rescue, hinder
reset	reset, affect, hit, kill, override, refresh, activate, correct, interrupt, reboot
warm	warm, heat, touch, cool, melt, cold, chill, hurt, freeze, hit
raise	raise, affect, hit, move, touch, provoke, hurt, wake, kill, attack
worship	worship, serve, please, kill, love, obey, harm, hate, bless, destroy
rather	kill, affect, harm, injure, hurt, hit, cause, like, attack, help
stalk	stalk, attack, harass, kill, follow, threaten, harm, like, stalking, hit
spiral	affect, influence, hit, spiral, kill, destroy, cause, hurt, harm, injure
lives	kill, injure, harm, affect, cause, hurt, destroy, become, be, create
fal	kill, hurt, harm, injure, hit, affect, attack, touch, destroy, influence
decipher	confuse, read, understand, decipher, see, deceive, tell, hear, interpret, detect
criticize	criticize, insult, offend, compliment, praise, attack, influence, blame, critique, hurt
defer	defer, delay, stop, kill, avoid, interrupt, answer, beat, do, provoke
disembark	disembark, eject, attack, hit, kill, affect, cause, impact, harm, stop
thin	thin, kill, eat, affect, injure, hit, shrink, choke, touch, bite
color	color, affect, hurt, paint, resemble, touch, influence, change, hit, shade
salute	salute, insult, strike, respect, provoke, attack, hit, taunt, acknowledge, disrespect
ad	kill, harm, hurt, injure, affect, hit, attack, influence, cause, be
shot	shoot, kill, hit, shot, hurt, injure, harm, fire, strike, attack
retrieve	retrieve, fetch, get, acquire, attack, receive, possess, hit, grab, produce
don	kill, hit, affect, injure, eat, become, be, dominate, harm, attack
fat	fat, eat, kill, injure, affect, be, starve, hurt, weigh, feed
flower	flower, harm, hurt, kill, affect, bloom, attract, love, help, grow
delight	delight, amuse, please, annoy, entertain, pleasure, love, surprise, hurt, help
frost	frost, freeze, touch, kill, hurt, bite, harm, hit, injure, eat
weaken	weaken, injure, break, hurt, strengthen, harm, attack, affect, destroy, kill
slot	kill, hit, hurt, injure, harm, affect, attack, cause, influence, touch
juice	juice, kill, hit, affect, eat, injure, hurt, touch, harm, provoke
boycott	boycott, offend, harm, exclude, hurt, influence, annoy, insult, bully, affect
grave	kill, injure, harm, hurt, hit, murder, destroy, die, strike, shoot
sneak	sneak, steal, see, catch, trick, pass, deceive, hit, kill, attack
twist	twist, bend, move, turn, change, affect, touch, influence, hit, hurt
STOP	stop, interrupt, kill, hit, affect, hurt, block, harm, attack, cause
waiver	waiver, hurt, injure, touch, harm, restrain, stop, help, offend, affect
scrape	scrape, hit, scratch, strike, injure, slap, hurt, harm, kill, pinch
another	kill, affect, harm, injure, cause, hurt, do, be, become, influence
best	best, beat, kill, help, improve, like, affect, benefit, overtake, be
some	harm, injure, kill, cause, hurt, affect, do, be, hit, destroy
otherwise	kill, harm, injure, affect, hurt, influence, cause, attack, be, hit
intercept	intercept, interrupt, pass, stop, attack, receive, hit, avoid, evade, detect
quake	hit, shake, quake, strike, move, hurt, touch, injure, harm, kill
spy	spy, observe, see, deceive, watch, inform, tell, influence, betray, know
sub	kill, injure, harm, affect, hurt, become, hit, attack, destroy, be
specialize	become, help, influence, affect, specialize, resemble, dominate, be, improve, imitate
why	kill, cause, be, affect, influence, do, follow, hurt, become, hit
surge	hit, surge, overwhelm, increase, attack, affect, boost, push, accelerate, hurt
Sue	kill, hurt, harm, injure, hit, affect, attack, influence, destroy, cause
breach	breach, break, injure, hit, hurt, harm, enter, violate, attack, touch
welcome	welcome, greet, like, attract, invite, please, love, attack, hate, receive
impact	impact, affect, hit, influence, effect, touch, hurt, harm, injure, cause
three	kill, cause, hit, hurt, affect, injure, harm, attack, be, do
smack	smack, slap, hit, punch, strike, smash, bang, bump, beat, injure
re	injure, be, affect, re, harm, do, kill, become, hit, attack
scoop	scoop, catch, eat, hit, swallow, kill, bite, grab, punch, touch
done	do, kill, cause, affect, hurt, stop, hit, injure, become, destroy
something	cause, affect, kill, do, hurt, harm, injure, be, hit, become
cold	cold, freeze, kill, warm, chill, touch, hurt, hit, heat, harm
consult	consult, advise, influence, inform, tell, instruct, affect, see, harm, cause
peel	peel, bite, eat, touch, kill, hit, hurt, remove, harm, damage
trial	injure, kill, murder, harm, hurt, trial, sue, execute, attack, try
grunt	grunt, hit, slap, kick, bite, curse, annoy, hurt, strike, punch
dope	dope, smoke, harm, drug, kill, beat, hit, hurt, influence, use
RT	kill, affect, hit, hurt, attack, harm, injure, touch, stop, bite
slap	slap, hit, smack, punch, beat, strike, bite, hurt, touch, pinch
nothing	kill, harm, hurt, cause, destroy, injure, hit, affect, stop, do
final	kill, harm, hurt, injure, affect, hit, cause, destroy, be, attack
require	require, need, satisfy, become, make, cause, be, consume, provide, desire
prey	kill, attack, eat, catch, harm, prey, attract, bite, hit, hurt
alter	alter, change, affect, influence, modify, effect, become, resemble, cause, move
chose	choose, become, select, kill, be, influence, affect, chose, cause, elect
lag	lag, delay, follow, beat, move, affect, slow, hit, miss, accelerate
journey	harm, injure, cause, kill, move, affect, overcome, hurt, follow, drive
film	kill, film, affect, harm, shoot, attack, hit, animate, stop, attract
because	kill, hurt, hit, harm, affect, injure, attack, cause, stop, be
tend	tend, affect, kill, cause, harm, help, attract, hurt, injure, influence
force	force, push, compel, influence, touch, cause, affect, hurt, make, provoke
worse	hurt, harm, injure, affect, kill, help, improve, like, make, become
mark	mark, hit, write, touch, kill, see, identify, strike, be, move
ly	kill, hurt, harm, injure, hit, affect, attack, touch, destroy, cause
parole	kill, injure, harm, hurt, attack, affect, shoot, stop, provoke, cause
neither	kill, harm, hurt, injure, hit, affect, be, become, attack, destroy
chase	chase, catch, follow, pursue, attack, hit, stop, beat, kill, evade
boo	boo, cheer, insult, hit, bully, kiss, annoy, punch, criticize, taunt
insult	insult, injure, offend, harm, hurt, attack, provoke, disrespect, abuse, threaten
implant	implant, affect, infect, become, replace, kill, create, produce, change, cause
kids	hurt, kill, harm, injure, hit, bite, affect, be, cause, stop
aim	hit, shoot, aim, affect, strike, kill, target, miss, touch, influence
research	affect, harm, cause, kill, attack, influence, attract, provoke, injure, like
mesh	become, affect, mesh, be, resemble, effect, complement, replace, cross, follow
smear	smear, slander, attack, insult, harm, discredit, dislike, deceive, destroy, offend
root	root, affect, cause, be, create, seed, become, influence, kill, harm
probe	probe, investigate, touch, disturb, question, see, provoke, affect, examine, harm
children	harm, kill, injure, hurt, cause, affect, produce, be, destroy, become
glory	defeat, beat, destroy, help, benefit, kill, harm, overcome, overtake, save
somewhere	kill, hit, hurt, be, harm, injure, cause, become, affect, move
thrill	thrill, scare, hurt, kill, attract, annoy, amuse, please, provoke, delight
mistake	confuse, misunderstand, mistake, deceive, mislead, misinterpret, fool, miss, see, error
branch	branch, interrupt, follow, influence, bite, affect, spur, provoke, move, cause
tower	tower, kill, overcome, topple, hit, injure, attack, crush, climb, overtake
triple	double, triple, increase, multiply, exceed, be, hit, reduce, hurt, become
sin	harm, sin, offend, hurt, kill, injure, cause, influence, deceive, corrupt
response	affect, provoke, hit, respond, attack, answer, hurt, kill, stop, attract
family	kill, injure, harm, hurt, affect, become, be, hit, destroy, cause
radio	kill, harm, hurt, injure, hit, attack, affect, cause, stop, influence
co	kill, hurt, harm, injure, hit, affect, attack, cause, influence, destroy
clot	clot, affect, bleed, kill, eat, hurt, injure, harm, bite, become
embarrass	embarrass, insult, annoy, offend, upset, ridicule, hurt, harass, affect, impress
select	select, choose, pick, affect, follow, replace, become, kill, attract, be
orgasm	pleasure, touch, hurt, orgasm, affect, stimulate, rape, kill, satisfy, penetrate
success	succeed, help, defeat, benefit, influence, affect, assist, beat, stop, become
affect	affect, effect, influence, impact, cause, harm, change, touch, help, make
suggest	suggest, contradict, influence, change, be, cause, affect, tell, become, follow
when	kill, hit, hurt, injure, harm, affect, be, cause, attack, become
prefer	prefer, like, favor, dislike, be, choose, beat, please, hate, influence
thunder	hit, thunder, strike, hurt, harm, injure, wake, bang, kill, affect
heel	heel, hit, hurt, attack, kick, beat, injure, harm, bite, influence
lament	lament, upset, offend, affect, blame, hurt, hate, annoy, criticize, love
w	kill, injure, harm, hurt, hit, affect, attack, cause, destroy, influence
but	kill, hurt, harm, hit, injure, affect, attack, be, destroy, stop
wheel	kill, affect, hit, injure, hurt, cause, attack, harm, stop, strike
mention	mention, say, notice, cause, affect, describe, invoke, quote, name, interrupt
instruct	instruct, teach, correct, obey, tell, direct, influence, affect, control, assist
passed	kill, harm, injure, hurt, affect, hit, cause, be, become, attack
tank	tank, affect, hit, hurt, kill, attack, fry, stun, stop, destroy
bad	harm, hurt, help, bad, injure, kill, do, affect, be, make
victory	defeat, beat, overcome, kill, destroy, overtake, win, stop, fight, help
discuss	discuss, cause, affect, provoke, influence, interrupt, debate, correct, inform, tell
company	kill, hurt, harm, injure, hit, affect, attack, cause, destroy, influence
overthrow	overthrow, oppose, destroy, topple, attack, kill, defeat, undermine, influence, change
did	kill, hurt, harm, injure, hit, affect, be, attack, cause, become
heed	heed, obey, hear, warn, affect, harm, notice, follow, offend, ignore
substitute	replace, substitute, become, be, imitate, change, produce, kill, contradict, resemble
dice	kill, hurt, harm, hit, injure, affect, attack, touch, destroy, influence
claw	claw, bite, scratch, attack, hurt, hit, touch, strike, stab, injure
hum	hum, disturb, annoy, wake, affect, harm, hit, stir, hear, hurt
heaven	kill, save, destroy, harm, help, love, hurt, injure, defeat, become
each	cause, kill, affect, harm, injure, hurt, hit, be, become, do
breast	kill, hurt, injure, harm, hit, attack, affect, eat, bite, touch
Maybe	kill, hurt, harm, injure, hit, affect, be, attack, become, help
penetrate	penetrate, enter, hit, touch, pass, affect, harm, destroy, hurt, injure
exceed	exceed, surpass, outweigh, overcome, overtake, be, become, beat, satisfy, equal
intensify	affect, provoke, intensify, annoy, hurt, attract, harm, injure, attack, effect
wax	wax, kill, touch, affect, attract, become, create, make, be, hurt
bubble	bubble, hurt, affect, explode, touch, hit, balloon, injure, burst, consume
transcend	transcend, overcome, become, transform, affect, be, change, create, cause, influence
shoulder	hit, shoulder, touch, push, strike, hurt, throw, shove, cross, knock
strut	hit, move, kick, strut, touch, hurt, upset, slap, insult, offend
twins	kill, hurt, harm, injure, hit, affect, attack, destroy, influence, cause
factor	affect, influence, factor, effect, cause, be, produce, attract, overcome, become
silence	silence, interrupt, hear, kill, stop, mute, harm, disturb, ignore, answer
comfort	comfort, hurt, help, touch, harm, reassure, please, love, affect, calm
obviously	kill, hurt, harm, injure, hit, affect, attack, cause, destroy, influence
speculate	influence, inform, mislead, question, confuse, provoke, tell, deceive, affect, cause
tweak	tweak, affect, change, alter, modify, influence, edit, move, effect, enhance
advocate	oppose, influence, support, benefit, persuade, advocate, offend, convince, help, harm
pose	pose, provoke, hit, attack, approach, strike, confront, kill, move, question
rate	rate, rank, beat, improve, score, affect, like, compliment, equal, pass
thanks	kill, hurt, harm, injure, affect, hit, attack, help, be, cause
blaze	burn, ignite, fire, destroy, hit, light, harm, strike, cause, kill
knows	kill, hurt, harm, injure, hit, affect, attack, cause, influence, destroy
buck	buck, hurt, hit, bang, bend, stop, jerk, move, kill, bite
describe	describe, be, become, cause, create, affect, change, explain, define, resemble
snack	eat, snack, feed, bite, distract, affect, consume, attack, starve, injure
fork	fork, kill, eat, bite, feed, offend, move, hurt, hit, choke
spark	spark, ignite, provoke, attract, cause, touch, stimulate, fire, create, trigger
specify	specify, cause, become, be, describe, affect, define, make, change, follow
parse	parse, confuse, affect, follow, read, interrupt, understand, attract, see, make
fake	fake, be, deceive, create, become, imitate, resemble, fool, believe, harm
pour	pour, drink, affect, drown, piss, kill, water, hit, effect, spill
glare	glare, hit, see, stare, notice, strike, touch, annoy, harm, provoke
itself	cause, kill, harm, affect, injure, hurt, attack, destroy, create, become
price	price, buy, affect, cost, hurt, value, harm, sell, be, pay
mom	kill, injure, hurt, harm, hit, affect, eat, attack, beat, be
Monday	kill, hurt, injure, harm, hit, affect, attack, cause, influence, destroy
chance	be, cause, chance, affect, surprise, strike, injure, hit, kill, happen
Tony	kill, hurt, injure, harm, hit, attack, affect, destroy, cause, influence
export	export, import, produce, harm, affect, create, destroy, attract, become, send
realise	realise, affect, see, notice, cause, deceive, influence, perceive, stop, recognise
unlock	unlock, kill, open, disable, attack, activate, stop, defeat, control, lock
plug	plug, hit, hurt, charge, stop, affect, cause, injure, disable, eat
stretch	stretch, pinch, push, bend, hurt, injure, move, extend, touch, deform
personally	affect, kill, injure, harm, hurt, hit, touch, attack, influence, cause
nonetheless	kill, hurt, harm, injure, hit, affect, attack, influence, destroy, touch
tel	kill, hurt, harm, injure, hit, affect, attack, touch, cause, influence
reckon	affect, injure, cause, hit, harm, hurt, kill, destroy, insult, influence
week	kill, hurt, injure, harm, hit, affect, cause, attack, influence, destroy
disrupt	disrupt, interrupt, disturb, affect, harm, upset, destroy, effect, distract, influence
administer	administer, harm, affect, abuse, restrain, injure, control, effect, kill, cause
smash	smash, hit, break, strike, crush, knock, destroy, impact, punch, beat
person	affect, kill, cause, be, harm, injure, hurt, do, become, create
enlarge	enlarge, expand, increase, affect, shrink, reduce, exceed, become, attract, outweigh
before	kill, hit, harm, hurt, injure, affect, cause, attack, be, become
simmer	boil, kill, simmer, provoke, affect, burn, heat, hurt, harm, stir
Friday	kill, hurt, injure, harm, hit, affect, attack, cause, influence, be
presume	presume, be, assume, mislead, deceive, believe, infer, misunderstand, suspect, become
remains	kill, become, be, affect, harm, destroy, injure, hurt, cause, hit
adhere	obey, follow, please, offend, contradict, affect, influence, stop, attract, resist
prize	injure, defeat, affect, beat, kill, attract, win, lose, benefit, hurt
sheep	kill, hurt, harm, injure, hit, attack, affect, destroy, be, cause
KO	kill, ko, attack, hurt, hit, fight, harm, injure, affect, stop
distort	distort, deceive, affect, influence, confuse, contradict, mislead, alter, change, misunderstand
pardon	pardon, forgive, offend, kill, help, punish, excuse, execute, obey, correct
prioritize	outweigh, prioritize, favor, benefit, overtake, beat, influence, affect, dominate, help
el	kill, hurt, harm, injure, hit, affect, attack, cause, influence, destroy
assemble	assemble, join, attack, produce, attract, separate, destroy, affect, kill, cause
seed	seed, produce, create, spawn, affect, sow, cause, infect, kill, destroy
threaten	threaten, harm, provoke, hurt, intimidate, attack, injure, kill, harass, threat
anymore	kill, hurt, hit, harm, injure, affect, attack, destroy, influence, touch
suppose	suppose, think, be, deceive, guess, believe, confuse, become, affect, contradict
scout	scout, see, warn, find, notice, follow, observe, harass, kill, attack
people	cause, kill, affect, hurt, harm, injure, do, be, make, effect
dad	kill, hurt, hit, injure, harm, attack, affect, destroy, cause, stop
crush	crush, hit, hurt, smash, kill, injure, break, destroy, touch, strike
crown	kill, crown, oppress, injure, harm, attack, slay, destroy, become, be
through	pass, cross, hit, kill, overcome, strike, through, break, penetrate, see
intersect	intersect, affect, become, be, cause, influence, touch, follow, create, cross
runaway	chase, hit, injure, follow, hurt, harm, restrain, escape, kill, drive
spear	kill, hit, injure, hurt, attack, harm, shoot, strike, bite, stab
dissent	offend, influence, insult, oppose, criticize, provoke, hurt, harm, upset, attack
audition	audition, recruit, hire, entertain, attract, imitate, be, impress, reject, become
stream	stream, feed, follow, kill, interrupt, affect, attract, stop, channel, become
shutter	shutter, shoot, hit, stop, kill, touch, trigger, affect, see, hurt
wee	wee, pee, wet, fart, affect, piss, milk, touch, overtake, stop
hitch	hitch, hit, hurt, harm, injure, slap, bite, wake, delay, strike
rust	rust, hurt, damage, break, hit, affect, attack, harm, injure, bite
seat	seat, hit, affect, move, injure, eject, stop, hurt, strike, overtake
bottom	bottom, top, hit, affect, topple, kill, lower, crush, stop, beat
flare	burn, ignite, flare, touch, hurt, provoke, fire, affect, hit, spark
weave	weave, deceive, bind, warp, touch, attack, strike, create, turn, affect
spray	spray, hit, shoot, touch, kill, attack, affect, smell, hurt, strike
revel	harm, provoke, amuse, kill, please, offend, love, celebrate, pleasure, delight
stain	stain, affect, paint, damage, destroy, hurt, harm, wet, ruin, touch
big	kill, hurt, hit, injure, affect, harm, attack, eat, stop, cause
apprentice	kill, injure, harm, affect, attack, hurt, influence, become, be, hit
U	kill, hurt, injure, hit, harm, affect, attack, help, influence, touch
invent	invent, create, cause, produce, influence, affect, make, become, kill, change
moon	kill, hit, affect, hurt, harm, attack, injure, destroy, eat, stop
remake	kill, affect, injure, become, harm, change, destroy, cause, influence, be
iron	injure, kill, affect, hit, attack, iron, strike, hurt, bite, harm
brood	brood, hurt, bother, annoy, affect, kill, harm, disturb, upset, torment
zoom	zoom, see, move, hit, touch, affect, follow, trip, influence, stop
equal	equal, be, affect, make, become, create, replace, complement, increase, produce
wrap	wrap, catch, hit, touch, restrain, injure, suspend, hurt, break, slap
Earth	kill, harm, cause, destroy, hurt, injure, create, hit, attack, eat
ease	ease, help, relax, relieve, hurt, injure, upset, affect, kill, assist
boys	kill, injure, hurt, harm, hit, attack, be, affect, destroy, beat
assassinate	kill, assassinate, shoot, murder, attack, harm, injure, execute, hit, threaten
apparently	kill, harm, hurt, injure, hit, affect, attack, cause, be, influence
condemn	condemn, offend, criticize, hate, insult, oppose, denounce, dislike, kill, judge
couple	marry, attract, couple, love, become, kill, bite, be, kiss, meet
barbecue	kill, attack, injure, harm, eat, hurt, hit, provoke, insult, fire
March	kill, hurt, injure, hit, harm, attack, affect, touch, strike, destroy
milk	milk, kill, feed, eat, hurt, hit, attack, affect, bite, harm
encounter	encounter, affect, meet, attract, touch, see, approach, kill, attack, cause
summon	summon, summons, call, attract, create, attack, invoke, kill, make, activate
blitz	blitz, attack, hit, kill, overtake, affect, stop, accelerate, destroy, stun
al	kill, hurt, harm, injure, hit, affect, attack, influence, destroy, cause
seek	seek, find, pursue, want, harm, follow, desire, attract, help, avoid
Rock	kill, hurt, harm, injure, hit, affect, attack, influence, destroy, touch
flap	flap, fly, touch, hit, attack, flip, bite, swat, move, strike
stuff	stuff, hurt, hit, affect, annoy, fuck, do, attract, upset, bother
for	for, kill, cause, be, harm, do, hit, get, strike, help
whatever	kill, cause, harm, hit, injure, affect, be, hurt, do, produce
fuss	upset, fuss, annoy, bother, disturb, affect, wake, hit, touch, harass
effect	effect, affect, influence, cause, do, stop, harm, control, benefit, kill
duel	kill, fight, duel, attack, shoot, challenge, injure, defeat, slay, hurt
short	short, shorten, stop, delay, interrupt, choke, touch, slow, cut, hear
strive	help, improve, benefit, please, harm, hurt, satisfy, succeed, surpass, offend
occupy	occupy, take, evict, overtake, move, possess, remove, invade, consume, replace
slaughter	kill, slaughter, murder, harm, attack, shoot, eat, destroy, injure, hurt
rub	rub, touch, hit, scratch, shove, pinch, push, bump, slap, hurt
bar	bar, harm, attack, hit, offend, strike, hurt, injure, kill, provoke
redeem	redeem, save, kill, become, convert, change, destroy, corrupt, be, correct
plea	kill, hurt, harm, injure, hit, affect, attack, cause, touch, influence
dodge	dodge, hit, avoid, evade, shoot, miss, cross, pass, move, strike
plant	plant, eat, kill, produce, seed, harm, affect, hurt, attract, attack
DO	do, cause, be, kill, affect, like, stop, help, hurt, hit
crop	kill, produce, affect, injure, eat, harm, hit, hurt, cause, destroy
since	kill, hurt, harm, injure, hit, affect, attack, cause, influence, be
obsess	affect, upset, influence, annoy, obsess, control, kill, attract, worry, possess
exhibit	affect, exhibit, provoke, attract, influence, cause, attack, effect, show, injure
trans	kill, harm, hurt, injure, affect, hit, be, become, attack, cause
revisit	affect, hit, visit, revisit, revive, kill, attack, resemble, attract, become
flesh	kill, harm, eat, injure, become, affect, be, create, hurt, attack
hedge	hedge, harm, attack, threaten, kill, provoke, affect, hit, delay, injure
house	kill, harm, hit, house, injure, attack, destroy, attract, produce, provoke
refill	kill, affect, consume, hit, attack, injure, eat, hurt, harm, refill
install	install, update, uninstall, disable, infect, notify, affect, execute, kill, download
snake	kill, hurt, hit, harm, injure, attack, affect, bite, touch, eat
minister	affect, harm, cause, offend, produce, oppress, influence, contradict, help, provoke
remind	injure, hurt, kill, affect, hit, harm, provoke, attack, stop, annoy
percent	kill, hurt, harm, injure, hit, affect, attack, cause, destroy, be
human	kill, affect, injure, harm, be, cause, become, create, hurt, eat
ignore	ignore, disregard, avoid, dismiss, hit, notice, affect, miss, annoy, neglect
kind	kind, like, help, hurt, love, make, cause, be, injure, mean
fell	fall, hit, kill, drop, strike, hurt, injure, harm, knock, break
alright	kill, hurt, harm, injure, hit, affect, attack, touch, destroy, influence
calm	calm, control, affect, restrain, relax, upset, quiet, provoke, reassure, chill
usually	kill, hurt, harm, injure, hit, affect, cause, attack, influence, be
retake	kill, hurt, hit, injure, harm, attack, affect, touch, influence, stop
justice	help, kill, harm, save, hurt, punish, injure, stop, destroy, beat
filter	filter, affect, influence, hear, effect, confuse, attract, pass, delay, convert
brown	brown, burn, kill, eat, affect, hurt, hit, attack, harm, color
analyze	analyze, affect, influence, provoke, examine, understand, confuse, cause, attract, study
quarrel	hurt, injure, harm, offend, annoy, insult, attack, provoke, kill, hit
treat	treat, affect, hurt, harm, hit, injure, kill, attack, help, touch
interact	affect, touch, influence, effect, attract, cause, contact, hit, control, harm
accidentally	injure, kill, hit, hurt, harm, affect, touch, cause, provoke, influence
birth	kill, become, produce, create, cause, be, birth, affect, infect, reproduce
scratch	scratch, hit, bite, touch, injure, strike, attack, damage, hurt, kill
aspire	become, be, influence, imitate, surpass, inspire, please, succeed, aspire, help
Wrestle	kill, hurt, injure, harm, hit, affect, attack, touch, destroy, influence
or	injure, affect, cause, or, be, kill, become, hurt, hit, do
comeback	revive, fight, hurt, attack, hit, resurrect, kill, harm, become, be
trespass	trespass, harm, harass, disturb, provoke, attack, injure, hurt, threaten, follow
sack	sack, kill, injure, strike, hit, attack, harm, eat, hurt, overtake
retain	retain, lose, replace, change, become, acquire, affect, keep, remove, destroy
issue	affect, issue, provoke, cause, attack, injure, shoot, offend, threaten, harm
vacation	vacation, visit, injure, kill, affect, harm, annoy, hurt, be, offend
grasp	touch, grasp, grab, catch, hit, move, deceive, confuse, see, strike
recap	kill, hurt, harm, injure, hit, affect, attack, cause, influence, destroy
plunge	hit, kill, plunge, drop, sink, hurt, touch, strike, impact, affect
butt	hit, butt, hurt, punch, kick, injure, smack, strike, slap, beat
mold	mold, mould, deform, change, resemble, become, affect, make, hurt, shape
ash	burn, destroy, kill, harm, hit, injure, fire, consume, eat, melt
great	kill, harm, cause, injure, affect, become, destroy, hurt, be, create
grade	grade, pass, rank, teach, fail, affect, influence, beat, do, correct
label	label, identify, describe, name, be, define, call, attract, affect, become
master	master, teach, defeat, dominate, control, become, obey, kill, make, beat
certainly	kill, hurt, harm, injure, hit, affect, attack, influence, cause, destroy
link	link, connect, cause, attract, follow, affect, join, influence, bind, help
credit	credit, repay, pay, help, owe, benefit, be, assist, produce, harm
dose	dose, affect, inject, effect, harm, kill, poison, overdose, hit, drug
attract	attract, like, affect, avoid, resemble, love, impress, influence, provoke, annoy
jet	kill, hurt, hit, injure, harm, affect, attack, touch, influence, cause
Jack	kill, injure, hit, hurt, harm, attack, affect, strike, destroy, touch
tag	tag, hit, follow, attack, bite, be, attract, kill, eat, fight
fool	fool, trick, deceive, confuse, mislead, hurt, influence, kill, fail, see
rotate	rotate, move, hit, affect, spin, turn, flip, influence, touch, change
mislead	mislead, deceive, confuse, misunderstand, fool, trick, influence, tell, contradict, manipulate
uphold	injure, harm, kill, destroy, offend, attack, hurt, affect, oppose, break
pit	kill, hit, hurt, injure, harm, attack, affect, strike, bite, eat
Read	kill, hurt, affect, harm, injure, attack, hit, cause, stop, influence
egg	kill, hit, harm, hurt, affect, attack, injure, eat, bite, annoy
naturally	kill, harm, hurt, affect, injure, hit, cause, influence, attack, destroy
degrade	degrade, harm, affect, destroy, injure, hurt, change, damage, become, kill
pulse	pulse, touch, kill, affect, stimulate, hurt, hit, beat, attack, harm
tap	tap, touch, hit, punch, prompt, strike, bite, slap, push, interrupt
number	number, affect, multiply, be, count, become, cause, create, produce, follow
deter	deter, provoke, attract, discourage, harm, stop, annoy, hurt, attack, bother
action	affect, influence, cause, effect, stop, kill, provoke, harm, do, help
ramp	attack, kill, affect, accelerate, hurt, injure, ramp, harm, hit, fight
others	harm, injure, affect, hurt, kill, cause, be, do, destroy, effect
owe	owe, repay, pay, borrow, owes, owing, give, owed, help, be
completely	kill, destroy, affect, harm, hurt, injure, hit, stop, eliminate, attack
exactly	kill, hurt, harm, hit, affect, injure, be, attack, cause, become
overturn	overturn, affect, change, influence, break, destroy, overthrow, overcome, effect, correct
dwarf	kill, hurt, injure, harm, hit, affect, attack, touch, destroy, influence
injury	injure, hurt, harm, hit, kill, attack, damage, strike, touch, injury
advertise	advertise, promote, deceive, offend, attract, imitate, be, harm, influence, inform
cow	cow, kill, hurt, milk, eat, hit, harm, attack, injure, choke
breath	kill, touch, breath, breathe, affect, stop, hit, harm, attack, hurt
pant	pant, touch, hurt, wet, smell, bite, fart, stop, affect, pants
gossip	insult, gossip, slander, tell, harass, criticize, annoy, offend, influence, dislike
parade	parade, harm, attack, provoke, kill, see, follow, harass, beat, injure
purchase	buy, purchase, sell, acquire, produce, affect, benefit, harm, influence, kill
differentiate	distinguish, be, differentiate, become, confuse, influence, affect, resemble, separate, understand
bastard	kill, hurt, injure, harm, hit, attack, affect, destroy, be, touch
pen	write, pen, kill, quote, hit, draw, stop, read, bite, provoke
scrap	scrap, hit, strike, kill, punch, injure, destroy, harm, attack, smash
combine	cause, affect, become, combine, create, be, kill, effect, produce, influence
Mars	kill, harm, hit, destroy, hurt, attack, injure, affect, eat, cause
amount	affect, increase, equal, effect, reduce, exceed, be, produce, measure, consume
grind	grind, kill, hurt, destroy, affect, hit, beat, harm, deceive, strike
recently	kill, hurt, harm, injure, hit, affect, attack, cause, influence, destroy
bully	bully, intimidate, harass, hurt, attack, bullying, hit, taunt, abuse, threaten
PR	kill, hurt, harm, injure, hit, affect, attack, destroy, influence, cause
bank	attack, kill, affect, rob, harm, bank, injure, stop, hurt, hit
Phoenix	kill, hurt, harm, injure, hit, affect, attack, destroy, touch, influence
display	display, affect, show, see, attract, influence, observe, effect, distract, notice
November	kill, hurt, injure, harm, hit, affect, attack, cause, destroy, influence
missed	kill, hurt, injure, harm, hit, affect, attack, cause, influence, touch
inside	kill, attack, hit, injure, overcome, hurt, inside, affect, eat, attract
extend	extend, become, be, affect, expand, follow, shorten, exclude, delay, effect
moderate	moderate, affect, influence, cause, harm, restrain, hurt, provoke, control, change
moment	affect, cause, provoke, kill, influence, effect, become, stop, injure, create
swat	swat, hit, bite, slap, attack, touch, strike, hurt, smack, injure
whiff	whiff, smell, hit, touch, catch, attract, sniff, strike, bite, punch
guys	kill, hurt, injure, hit, attack, affect, be, attract, like, fuck
changed	change, affect, become, be, influence, alter, resemble, changed, modify, replace
years	kill, injure, hurt, harm, hit, affect, cause, attack, destroy, be
damage	damage, harm, injure, hit, hurt, affect, destroy, attack, kill, break
ban	ban, offend, harm, affect, stop, block, harass, exclude, kill, attack
his	kill, attack, injure, harm, hit, affect, be, hurt, possess, have
almost	kill, hurt, harm, injure, hit, affect, attack, destroy, touch, stop
Do	kill, affect, do, cause, be, become, hurt, stop, injure, hit
cater	affect, kill, eat, hit, attack, hurt, harm, injure, attract, cause
process	process, affect, cause, effect, influence, stop, trigger, hurt, tell, delay
brief	kill, injure, brief, affect, interrupt, attack, stop, wake, see, delay
cluster	cluster, attract, cause, hit, affect, influence, dominate, infect, join, surround
motivate	motivate, inspire, attract, encourage, affect, influence, drive, provoke, help, stimulate
mess	mess, confuse, affect, help, disturb, hurt, screw, annoy, follow, wake
coordinate	coordinate, cause, influence, affect, move, control, effect, follow, do, be
infiltrate	infiltrate, penetrate, attack, infect, enter, influence, kill, attract, destroy, defeat
deceive	deceive, mislead, fool, manipulate, cheat, confuse, trick, harm, betray, influence
LOL	annoy, hit, affect, kill, taunt, stop, hurt, upset, attack, like
bang	bang, hit, punch, knock, hurt, smack, beat, slap, slam, strike
wow	kill, hit, impress, affect, hurt, attract, injure, annoy, attack, like
scare	scare, threaten, harm, fear, kill, hurt, intimidate, warn, alarm, disturb
illuminate	illuminate, light, see, affect, influence, attract, confuse, cause, harm, wake
amplify	amplify, affect, enhance, hear, influence, effect, echo, attract, harm, annoy
exchange	exchange, give, acquire, receive, become, buy, be, produce, pay, kill
overwhelm	overwhelm, overpower, overcome, affect, dominate, defeat, overtake, upset, attack, destroy
of	kill, harm, be, affect, cause, injure, destroy, become, of, hurt
pivot	move, influence, affect, change, hit, cause, follow, pivot, stop, touch
glitch	glitch, affect, interrupt, confuse, crash, harm, break, malfunction, fail, corrupt
decode	decode, confuse, read, encode, tell, decrypt, deceive, understand, hear, see
blend	become, be, affect, resemble, influence, kill, confuse, cross, separate, follow
contact	contact, touch, affect, harm, call, hit, attract, encounter, reach, approach
bury	bury, kill, destroy, hit, eat, injure, hurt, murder, slay, harm
broken	break, hit, injure, hurt, kill, harm, destroy, beat, affect, strike
monitor	monitor, observe, watch, affect, influence, see, control, detect, follow, notice
ticket	hit, injure, kill, hurt, affect, harm, attack, stop, strike, touch
prick	prick, touch, hurt, pinch, poke, bite, hit, scratch, injure, shoot
season	affect, kill, injure, harm, cause, hurt, hit, influence, attack, effect
transplant	transplant, infect, become, kill, replace, produce, affect, be, change, cure
GO	kill, be, follow, attack, affect, become, harm, cause, destroy, move
food	kill, injure, harm, eat, hurt, attack, hit, affect, bite, touch
is	be, kill, become, affect, cause, harm, injure, hurt, hit, destroy
subpoena	subpoena, harass, compel, attack, summon, provoke, harm, produce, see, threaten
drill	drill, hit, hurt, strike, kill, attack, injure, shoot, bite, annoy
login	login, notify, visit, log, access, interrupt, attack, see, be, contact
lap	pass, overtake, hit, lap, catch, beat, chase, evade, move, avoid
deepen	hurt, injure, kill, affect, harm, attack, provoke, hit, cause, touch
shy	provoke, intimidate, shy, like, bully, scare, fear, avoid, dislike, resemble
error	error, correct, confuse, deceive, mislead, fail, err, misunderstand, affect, interrupt
gorge	gorge, injure, eat, kill, hurt, harm, feed, bite, attack, poison
Lord	kill, harm, injure, hurt, hit, affect, attack, destroy, cause, help
sled	kill, hurt, hit, injure, harm, affect, attack, touch, cause, influence
alive	kill, save, harm, animate, injure, eat, be, revive, become, live
Not	kill, harm, hurt, injure, hit, affect, attack, be, destroy, cause
evade	evade, avoid, escape, deceive, kill, hit, dodge, follow, distract, overtake
drain	drain, affect, consume, kill, drown, destroy, eat, exhaust, harm, feed
Jeff	kill, hurt, harm, injure, hit, affect, attack, destroy, cause, touch
flight	hit, kill, fly, attack, strike, harm, injure, hurt, touch, flight
b	injure, affect, harm, be, b, hit, hurt, attack, kill, stop
crib	harm, kill, injure, hurt, hit, annoy, offend, attack, interrupt, provoke
trail	trail, follow, hit, kill, track, chase, hurt, injure, harm, lose
cream	kill, hurt, hit, injure, affect, harm, attack, touch, eat, bite
squat	squat, hit, squash, move, injure, kick, hurt, touch, lift, kill
Steve	kill, hurt, harm, injure, hit, attack, affect, destroy, cause, influence
ex	ex, kill, injure, become, hurt, harm, attract, destroy, affect, attack
ed	kill, hurt, harm, injure, hit, affect, attack, cause, influence, destroy
everything	kill, affect, cause, destroy, harm, hurt, be, do, injure, become
hook	hook, catch, bait, hit, attract, kill, get, fuck, grab, bang
inquire	question, ask, query, answer, cause, inquire, inform, provoke, tell, know
NEVER	kill, hurt, harm, injure, hit, affect, attack, destroy, be, influence
comprehend	understand, comprehend, confuse, affect, see, perceive, deceive, influence, cause, read
sport	injure, kill, hurt, hit, harm, beat, affect, attack, provoke, fight
slash	slash, stab, cut, hit, strike, kill, punch, injure, slice, attack
promote	promote, harm, influence, help, encourage, benefit, oppose, cause, create, affect
bag	bag, hit, punch, grab, hurt, catch, eat, injure, kill, bite
least	kill, injure, harm, hurt, hit, affect, attack, cause, be, destroy
church	kill, offend, hurt, harm, murder, attack, convert, injure, worship, follow
port	harm, affect, attack, kill, attract, produce, stop, injure, harass, become
attach	attach, attract, detach, injure, touch, bind, affect, hurt, possess, distract
woo	woo, attract, like, kiss, love, befriend, impress, influence, date, want
swap	swap, become, change, kill, replace, be, switch, move, create, affect
blue	blue, hit, hurt, attack, kill, affect, injure, see, touch, strike
ok	kill, hurt, hit, harm, injure, affect, attack, help, stop, destroy
trouble	hurt, trouble, harm, injure, annoy, bother, affect, provoke, upset, offend
ten	hit, kill, affect, attack, injure, be, bite, stop, strike, beat
endorse	endorse, support, oppose, influence, encourage, like, persuade, favor, change, help
may	affect, cause, harm, kill, produce, become, attack, influence, control, do
grown	kill, injure, affect, hurt, harm, become, change, eat, destroy, resemble
appropriate	kill, affect, harm, injure, be, hurt, cause, become, hit, influence
S	kill, injure, affect, hurt, harm, hit, be, attack, cause, stop
Rebel	kill, hurt, harm, injure, hit, affect, attack, destroy, influence, touch
phase	phase, affect, delay, interrupt, kill, stop, process, effect, hurt, phases
throttle	throttle, hit, accelerate, choke, kill, harm, stop, slow, injure, attack
loss	lose, injure, affect, harm, kill, hurt, defeat, destroy, cause, become
sip	affect, touch, drink, influence, effect, swallow, hit, sip, consume, serve
condition	condition, affect, cause, effect, modify, change, produce, treat, influence, make
meltdown	hurt, upset, affect, hit, harm, overwhelm, attack, injure, threaten, destroy
dash	hit, dash, kill, strike, chase, attack, kick, injure, pass, touch
forward	move, stop, pass, forward, cause, advance, follow, assist, push, affect
would	kill, harm, hurt, affect, injure, hit, cause, be, become, influence
friend	friend, befriend, like, help, kill, love, know, attack, be, dislike
Greg	kill, hurt, harm, injure, hit, affect, attack, cause, destroy, influence
honey	kill, hurt, harm, injure, hit, affect, attack, touch, influence, cause
old	kill, become, injure, be, attack, eat, hurt, beat, affect, harm
rarely	kill, hurt, harm, injure, hit, affect, attack, destroy, influence, cause
reconstruct	affect, resemble, injure, change, become, cause, kill, distort, be, harm
case	cause, kill, influence, attract, be, see, effect, affect, hurt, hit
fails	kill, harm, hurt, injure, affect, hit, be, cause, destroy, become
t	t, affect, kill, stop, hit, be, injure, hurt, bite, do
few	injure, kill, hurt, harm, affect, be, cause, become, dominate, lose
early	kill, injure, hurt, hit, harm, attack, affect, beat, stop, eat
sure	kill, hurt, harm, injure, hit, affect, attack, cause, influence, destroy
abuse	abuse, harm, hurt, injure, attack, use, beat, hit, provoke, assault
adventure	kill, attack, injure, provoke, affect, harm, hurt, cause, stop, attract
pencil	kill, hit, hurt, injure, attack, affect, touch, bite, harm, strike
captain	kill, injure, hurt, harm, hit, affect, attack, cause, destroy, influence
harass	harass, attack, threaten, bully, provoke, harm, hurt, intimidate, harassment, annoy
punk	kill, hurt, harm, injure, hit, attack, affect, destroy, touch, bite
round	round, hit, turn, knock, circle, surround, strike, affect, bend, stop
directly	affect, harm, kill, hit, influence, cause, hurt, touch, effect, attack
compost	compost, eat, kill, consume, produce, affect, destroy, infect, hurt, feed
prod	prod, poke, touch, hurt, push, hit, strike, attack, stop, pinch
squeeze	squeeze, shove, push, hit, pinch, hurt, touch, grab, choke, hug
farewell	kill, harm, leave, lose, become, injure, love, destroy, be, follow
fray	provoke, fray, touch, hurt, injure, harm, upset, strike, fight, offend
everyone	affect, kill, cause, harm, hurt, injure, be, destroy, effect, hit
vest	affect, kill, effect, hurt, injure, become, harm, possess, vest, suspend
hammer	hammer, hit, strike, beat, hurt, attack, punch, bang, smash, batter
shape	shape, change, affect, make, form, influence, deform, alter, resemble, turn
failure	fail, defeat, succeed, destroy, kill, harm, break, affect, help, hurt
dial	dial, call, phone, tell, contact, answer, ring, summon, telephone, signal
Tell	kill, hurt, harm, injure, hit, affect, attack, cause, influence, destroy
employ	employ, use, injure, hire, attack, affect, kill, assist, strike, harm
validate	validate, negate, deny, refute, contradict, confirm, be, deceive, affect, convince
pro	kill, hurt, harm, injure, hit, affect, attack, destroy, influence, touch
within	kill, cause, affect, injure, harm, attack, destroy, become, hit, overcome
chop	chop, cut, hit, kill, bite, choke, eat, touch, injure, attack
grip	grip, touch, grab, hit, strike, hold, bite, grasp, punch, hurt
journal	journal, write, provoke, kill, tell, harm, affect, read, harass, interrupt
quiz	affect, influence, kill, hit, attack, annoy, taunt, provoke, bully, attract
team	kill, hurt, harm, hit, injure, affect, attack, help, cause, influence
poison	poison, kill, harm, hurt, murder, injure, attack, eat, infect, affect
sentence	sentence, interrupt, affect, follow, kill, provoke, speak, understand, obey, execute
induce	induce, cause, attract, provoke, affect, influence, effect, stimulate, create, produce
voice	hear, affect, speak, voice, silence, interrupt, call, tell, influence, answer
amp	kill, hurt, hit, harm, injure, affect, attack, touch, stop, cause
ret	kill, hurt, harm, injure, hit, affect, attack, touch, influence, destroy
sick	sick, hurt, kill, infect, harm, eat, injure, ail, ill, cure
green	green, kill, hurt, burn, affect, harm, touch, eat, stop, damage
audit	audit, affect, corrupt, attack, investigate, interrupt, abuse, influence, exhaust, inform
ry	hurt, kill, injure, harm, hit, cause, abuse, attack, provoke, do
incite	incite, provoke, cause, ignite, attract, injure, offend, harm, attack, threaten
Go	kill, stop, go, follow, become, do, be, defeat, attract, attack
confront	confront, provoke, attack, threaten, challenge, hit, affect, encounter, intimidate, harass
bleach	bleach, kill, affect, harm, infect, destroy, eat, attack, hurt, damage
worm	worm, infect, eat, bite, attack, kill, affect, hurt, harm, destroy
ta	kill, hurt, harm, hit, injure, affect, attack, touch, destroy, influence
Rule	kill, harm, hurt, injure, affect, hit, influence, cause, destroy, be
haha	kill, hurt, harm, hit, injure, affect, attack, touch, influence, destroy
quiet	silence, quiet, hear, disturb, stop, calm, interrupt, affect, mute, kill
crowd	crowd, attract, shove, hit, surround, punch, hug, push, attack, fight
lick	lick, bite, kiss, hit, touch, kick, eat, slap, attack, suck
inevitable	kill, harm, injure, hurt, affect, hit, be, become, destroy, attack
model	model, imitate, influence, affect, resemble, create, simulate, cause, copy, follow
overflow	overflow, overwhelm, exceed, affect, overload, flood, drain, drown, consume, fill
Pop	kill, hurt, harm, injure, hit, affect, attack, destroy, influence, cause
twice	kill, hit, hurt, harm, injure, affect, attack, destroy, touch, stop
counsel	counsel, advise, instruct, influence, harm, injure, tell, cause, consult, persuade
treasure	treasure, steal, love, harm, hurt, destroy, kill, possess, envy, injure
album	kill, hurt, harm, injure, hit, affect, attack, cause, influence, destroy
render	render, kill, affect, harm, animate, make, produce, become, destroy, attack
undo	undo, do, affect, destroy, damage, effect, cause, stop, remove, harm
future	kill, affect, become, cause, harm, create, injure, be, stop, produce
forgotten	kill, hurt, injure, harm, hit, affect, attack, be, destroy, become
thereafter	kill, hurt, harm, injure, hit, affect, attack, be, cause, influence
Twitter	tweet, follow, harass, threaten, retweet, insult, provoke, hit, attack, kill
award	injure, defeat, affect, win, beat, kill, award, influence, give, attack
air	touch, hit, affect, kill, air, fly, exhaust, attack, wake, eject
implement	implement, affect, effect, cause, execute, stop, prevent, change, influence, do
rig	injure, kill, hurt, hit, affect, provoke, influence, harm, attack, cause
instantly	kill, affect, hurt, injure, harm, hit, attack, stop, destroy, become
chain	chain, break, attract, control, attack, stop, kill, hit, provoke, follow
pine	pine, hurt, injure, harm, hit, touch, affect, kill, bite, see
cage	kill, injure, harm, hurt, hit, attack, affect, provoke, strike, bite
warp	warp, affect, deform, influence, touch, drive, damage, move, distort, accelerate
ferment	ferment, affect, infect, produce, consume, destroy, eat, kill, harm, cause
medal	kill, injure, hurt, hit, harm, affect, beat, defeat, attack, help
blood	kill, bite, hurt, murder, harm, hit, eat, attack, injure, stab
hour	kill, hurt, harm, injure, hit, affect, attack, cause, influence, touch
correspond	be, become, affect, cause, follow, resemble, know, influence, contradict, produce
drunk	drink, drunk, kill, affect, hit, influence, harm, injure, hurt, drive
inject	inject, kill, infect, provoke, shoot, affect, harm, create, injure, attack
page	kill, hurt, harm, injure, hit, affect, attack, cause, influence, stop
amuse	amuse, annoy, entertain, offend, please, attract, provoke, insult, amused, affect
scramble	scramble, hit, confuse, chase, attack, kill, distract, move, alarm, wake
revolution	change, destroy, overthrow, kill, attack, affect, oppose, stop, oppress, save
happy	like, please, happy, help, love, satisfy, kill, hurt, annoy, affect
less	affect, reduce, harm, hurt, be, benefit, help, outweigh, increase, become
populate	kill, become, populate, replace, attract, affect, create, be, remove, destroy
o	kill, harm, hurt, injure, hit, affect, attack, influence, destroy, be
shutdown	shutdown, interrupt, stop, affect, block, disable, disconnect, kill, shut, silence
limit	limit, exceed, restrict, reduce, affect, contain, control, stop, cause, restrain
pan	pan, affect, hit, kill, harm, shoot, cross, touch, hurt, eat
sand	sand, hit, kick, destroy, move, hurt, strike, blow, touch, injure
er	kill, hurt, harm, injure, hit, affect, attack, destroy, cause, influence
grant	grant, give, deny, help, receive, ask, obey, aid, assist, do
surgery	kill, injure, hurt, harm, hit, affect, attack, eat, touch, bite
bullet	kill, hit, shoot, hurt, injure, harm, attack, strike, affect, stop
kickoff	kill, hit, hurt, injure, harm, affect, attack, strike, touch, stop
Know	kill, harm, hurt, injure, affect, hit, cause, be, attack, influence
jazz	kill, hurt, injure, harm, hit, affect, attack, influence, help, destroy
exhaust	exhaust, kill, consume, expel, destroy, attack, stop, affect, drive, eliminate
widen	widen, enlarge, expand, cross, affect, divide, narrow, broaden, shrink, grow
O	kill, harm, hurt, injure, hit, affect, attack, be, destroy, cause
five	kill, attack, shoot, affect, hit, injure, be, stop, bite, hurt
ov	kill, affect, harm, hurt, hit, injure, attack, destroy, eat, touch
respect	respect, please, like, disrespect, obey, love, honor, treat, hurt, dislike
entirely	kill, hurt, harm, injure, hit, affect, attack, destroy, be, become
publicly	kill, harm, hurt, injure, attack, hit, affect, destroy, influence, provoke
shuttle	kill, affect, hit, hurt, harm, injure, attract, attack, move, wake
transgress	transgress, offend, violate, injure, provoke, corrupt, harm, hurt, cross, touch
must	kill, cause, become, be, affect, obey, help, make, stop, do
borrow	borrow, lend, use, steal, loan, be, owe, influence, help, teach
tears	hurt, upset, touch, hit, harm, affect, kill, injure, insult, annoy
Rise	kill, harm, hurt, injure, affect, hit, attack, destroy, cause, influence
recount	affect, cause, injure, kill, tell, interrupt, attack, describe, wake, provoke
Christian	kill, harm, hurt, injure, hit, affect, destroy, attack, help, be
max	kill, hurt, hit, harm, injure, affect, attack, stop, cause, influence
diet	eat, starve, feed, diet, kill, affect, consume, satisfy, hurt, influence
wet	wet, water, touch, fuck, splash, piss, dry, hit, flood, affect
il	kill, hurt, harm, injure, hit, affect, attack, cause, destroy, touch
brush	brush, hit, touch, scratch, slap, punch, strike, bump, cross, smack
and	affect, cause, be, injure, kill, become, harm, influence, do, create
pink	pink, touch, hurt, color, hit, bleed, affect, attack, burn, eat
reassure	reassure, harm, hurt, threaten, scare, comfort, fear, injure, alarm, kill
reiterate	kill, affect, hit, injure, hurt, harm, attack, provoke, influence, interrupt
streak	injure, hurt, hit, kill, harm, attack, break, affect, strike, cross
poke	poke, hit, punch, prod, touch, hurt, pinch, stab, jab, bite
bunk	kill, hurt, harm, injure, hit, affect, attack, destroy, influence, touch
yourself	harm, cause, kill, injure, hurt, affect, do, be, destroy, become
Israel	kill, harm, injure, hurt, attack, destroy, murder, hit, cause, be
interest	interest, attract, like, affect, notice, resemble, influence, interested, impress, engage
limp	limp, move, hit, hurt, injure, push, kick, touch, drag, harm
class	class, injure, affect, hurt, hit, offend, strike, harm, teach, stop
Follow	kill, harm, hurt, injure, hit, affect, attack, cause, influence, destroy
app	kill, harm, hurt, hit, affect, injure, attack, cause, be, stop
gay	gay, kill, harm, like, love, hurt, be, hate, eat, homosexual
pace	pace, accelerate, speed, slow, beat, stop, overtake, move, impede, delay
recognise	recognise, recognize, see, notice, distinguish, resemble, identify, perceive, know, understand
stock	kill, injure, harm, hurt, affect, hit, cause, attack, destroy, influence
should	kill, affect, cause, injure, hurt, harm, be, attack, help, do
lunch	eat, kill, hurt, hit, injure, attack, affect, strike, bite, harm
things	affect, cause, do, hurt, be, kill, harm, become, things, create
pastor	kill, hurt, harm, injure, hit, affect, attack, cause, destroy, influence
hop	hop, jump, hit, ride, cross, pass, move, kill, chase, attract
soil	kill, soil, destroy, injure, hit, hurt, harm, eat, attack, affect
quite	kill, hurt, injure, harm, hit, affect, attack, touch, destroy, cause
sup	kill, harm, affect, injure, hurt, attack, hit, destroy, effect, eat
much	hurt, harm, injure, kill, affect, hit, annoy, attack, cause, offend
correlate	affect, cause, resemble, influence, be, follow, become, attract, like, contradict
bites	kill, hurt, hit, injure, harm, bite, attack, eat, affect, touch
animate	animate, move, kill, affect, attract, create, become, resemble, cause, touch
tan	tan, burn, hurt, kill, affect, harm, injure, touch, resemble, eat
contain	contain, produce, affect, destroy, create, attract, cause, make, possess, become
waste	waste, consume, use, kill, destroy, harm, eat, exhaust, produce, save
hem	kill, hurt, harm, injure, hit, affect, attack, influence, cause, touch
crew	kill, injure, hit, hurt, harm, attack, affect, cause, destroy, touch
stagger	stagger, hit, injure, strike, move, wake, hurt, throw, impact, disturb
Trump	kill, harm, attack, injure, hurt, be, destroy, influence, become, affect
toss	toss, throw, hit, punch, kick, move, flip, eject, catch, shove
DC	kill, hurt, harm, injure, hit, attack, affect, destroy, cause, influence
rampage	kill, attack, rampage, harm, shoot, murder, slaughter, hurt, strike, injure
thought	kill, affect, cause, harm, hurt, injure, influence, hit, stop, attack
redesign	affect, change, become, kill, be, resemble, destroy, create, replace, injure
simply	kill, harm, hurt, injure, affect, hit, attack, cause, destroy, stop
hij	kill, hurt, harm, injure, hit, affect, attack, cause, influence, destroy
divest	divest, sell, harm, influence, buy, affect, destroy, benefit, oppose, exclude
reclaim	reclaim, become, attack, be, possess, destroy, overtake, overcome, defeat, injure
target	target, hit, attack, affect, kill, harm, shoot, attract, hurt, strike
career	kill, harm, injure, hurt, affect, hit, cause, influence, attack, destroy
gladly	kill, hurt, harm, injure, hit, affect, attack, touch, influence, destroy
happened	kill, affect, hurt, cause, be, do, become, hit, harm, injure
dip	dip, drop, affect, hit, depress, touch, drown, move, hurt, cross