make	change, exist, appear, happen, die, move, suffer, occur, do, behave
do	do, act, happen, occur, die, exist, react, behave, suffer, harm
get	die, happen, leave, get, go, suffer, do, exist, occur, win
need	need, suffer, exist, die, fail, occur, disappear, help, hurt, arise
regret	regret, suffer, change, die, apologize, complain, fail, decline, think, hurt
find	exist, appear, find, disappear, occur, die, vanish, leave, return, happen
have	exist, die, occur, happen, have, live, appear, suffer, be, change
see	see, appear, look, exist, move, blink, react, speak, object, perceive
prove	exist, lie, die, believe, appear, prove, testify, succeed, disagree, occur
eat	die, eat, starve, bite, suffer, exist, vomit, kill, fall, attack
try	fail, succeed, try, suffer, fall, do, hurt, die, react, happen
know	know, exist, communicate, understand, speak, care, do, talk, act, be
like	like, dislike, behave, exist, hate, change, smile, love, respond, react
use	use, exist, fail, work, harm, occur, die, object, do, function
take	die, fall, leave, disappear, take, suffer, go, move, perish, lose
finish	finish, succeed, die, fail, start, stop, begin, continue, end, complete
win	win, lose, die, succeed, triumph, prevail, suffer, gain, fail, live
lose	die, lose, disappear, suffer, fall, perish, leave, go, win, vanish
love	love, exist, die, hate, live, change, suffer, marry, care, believe
own	exist, own, live, possess, die, inherit, sell, succeed, buy, share
say	speak, say, respond, occur, reply, happen, shout, appear, react, laugh
remember	remember, forget, recall, appear, exist, think, occur, speak, smile, return
handle	react, harm, fall, fight, move, attack, hurt, behave, act, die
deserve	deserve, suffer, die, exist, lose, fail, win, succeed, happen, occur
buy	buy, sell, exist, purchase, pay, die, live, suffer, succeed, profit
break	break, fall, die, fracture, shatter, fail, hurt, collapse, crack, suffer
catch	fall, escape, flee, die, disappear, appear, jump, move, catch, happen
fix	change, improve, exist, succeed, fail, work, suffer, happen, die, occur
miss	miss, occur, disappear, appear, fail, fall, move, happen, die, suffer
survive	survive, die, exist, perish, live, suffer, thrive, escape, succeed, disappear
believe	believe, lie, think, exist, act, fall, occur, behave, deceive, happen
kill	die, kill, perish, suffer, exist, death, live, fall, attack, murder
be	exist, appear, be, occur, change, die, happen, speak, disappear, arise
want	want, desire, exist, object, leave, wish, ask, happen, care, seek
admit	admit, confess, lie, acknowledge, exist, deceive, believe, respond, speak, apologize
hate	hate, die, exist, suffer, attack, dislike, retaliate, change, rage, despise
write	write, exist, die, occur, appear, respond, happen, reply, read, succeed
crush	fall, die, collapse, suffer, break, explode, hurt, disappear, fail, shatter
feel	feel, react, move, act, hurt, exist, touch, suffer, respond, happen
hear	hear, speak, sound, shout, scream, talk, listen, respond, laugh, stop
wear	wear, appear, change, exist, look, fall, be, dress, disappear, move
nail	fall, die, bite, strike, hurt, hit, attack, fight, kill, suffer
forget	forget, remember, disappear, die, exist, happen, appear, occur, fail, misunderstand
save	die, perish, live, survive, suffer, exist, succeed, escape, appear, fall
stop	stop, intervene, act, react, happen, move, flee, occur, die, fall
read	read, write, speak, appear, think, respond, see, talk, look, exist
destroy	die, exist, perish, suffer, destroy, fall, disappear, harm, kill, fail
sell	sell, buy, die, exist, perish, suffer, disappear, flee, purchase, fall
drink	drink, drunk, vomit, drown, consume, do, fall, drive, sip, cry
burn	burn, die, explode, perish, fire, fall, combust, ignite, flee, exist
call	respond, speak, answer, call, appear, shout, scream, yell, reply, occur
realize	realize, notice, recognize, know, exist, happen, understand, see, occur, think
earn	earn, win, succeed, rise, gain, pay, work, die, increase, exist
manage	fail, behave, succeed, manage, exist, act, occur, intervene, work, suffer
explain	explain, understand, speak, respond, appear, answer, talk, react, think, occur
pull	pull, fall, move, happen, act, jump, do, object, go, stop
recognize	recognize, appear, respond, exist, speak, move, notice, react, object, act
steal	steal, disappear, flee, leave, harm, die, suffer, fall, take, break
blow	explode, blow, die, fall, breathe, fly, happen, fail, occur, collapse
appreciate	appreciate, respond, smile, exist, benefit, love, suffer, improve, care, behave
bring	come, appear, arrive, return, leave, bring, visit, die, happen, exist
understand	understand, speak, respond, communicate, think, know, comprehend, talk, misunderstand, exist
throw	fall, throw, jump, hit, object, drop, move, strike, explode, flee
solve	solve, occur, exist, happen, succeed, appear, arise, suffer, fail, work
beat	die, lose, fall, win, fight, suffer, beat, cheat, attack, retaliate
enjoy	enjoy, suffer, laugh, smile, rejoice, pleasure, exist, benefit, delight, behave
learn	learn, understand, speak, know, do, fail, improve, change, succeed, teach
keep	leave, die, disappear, return, exist, change, stay, go, suffer, escape
show	appear, react, smile, look, act, respond, laugh, see, show, object
start	die, start, happen, stop, begin, occur, exist, fail, succeed, end
ruin	die, suffer, perish, fail, ruin, fall, happen, succeed, harm, exist
smoke	smoke, die, combust, drink, burn, fire, cough, consume, use, breathe
crack	crack, break, fall, die, fracture, explode, fail, collapse, occur, snap
accept	accept, change, exist, refuse, leave, believe, reject, die, respond, object
cut	die, bleed, fall, cut, hurt, bite, suffer, break, harm, scream
carry	fall, move, die, carry, walk, stumble, suffer, trip, fight, hurt
answer	answer, respond, reply, speak, talk, react, laugh, question, object, lie
swallow	drown, die, swallow, vomit, fall, eat, disappear, choke, breathe, exist
taste	taste, drink, react, vomit, bite, smell, eat, swallow, spit, gag
publish	publish, exist, appear, succeed, write, print, perish, disappear, occur, reproduce
give	give, die, receive, benefit, exist, suffer, live, leave, do, pay
open	open, close, shut, enter, break, fall, escape, exist, crack, leave
drop	drop, fall, die, disappear, fail, move, crash, jump, exist, happen
sign	sign, write, appear, exist, act, die, read, speak, contract, do
build	fail, build, exist, break, collapse, succeed, die, fall, work, grow
claim	claim, exist, die, lie, disappear, appear, fall, occur, vanish, succeed
end	die, end, perish, exist, suffer, occur, death, happen, stop, fail
post	post, publish, appear, exist, comment, occur, share, write, happen, disappear
print	print, appear, exist, publish, write, disappear, occur, copy, happen, read
smell	smell, sniff, move, cough, vomit, breathe, faint, stink, appear, react
touch	move, fall, react, appear, object, hurt, touch, scream, die, suffer
hit	fall, hit, hurt, die, strike, harm, move, retaliate, react, suffer
doubt	doubt, believe, lie, disagree, fail, suspect, question, distrust, fear, complain
attempt	fail, succeed, fall, attempt, die, intervene, occur, attack, try, happen
tell	lie, speak, believe, respond, react, think, laugh, talk, act, listen
discover	discover, exist, know, appear, occur, find, change, happen, die, learn
name	exist, appear, occur, name, speak, die, happen, be, change, arise
share	share, eat, occur, exist, suffer, lose, exchange, leave, take, fail
fight	fight, die, lose, fall, attack, flee, suffer, harm, leave, win
grab	fall, grab, move, flee, jump, disappear, bite, attack, object, appear
spill	spill, drink, vomit, fall, drown, drop, leak, happen, choke, explode
report	report, complain, leave, disappear, flee, appear, occur, respond, die, investigate
hold	fall, move, hold, break, touch, recoil, shake, object, grasp, drop
pass	pass, cross, fail, move, fall, appear, stop, walk, die, go
close	close, open, shut, break, die, leave, escape, collapse, fall, enter
think	think, believe, act, exist, react, speak, occur, behave, happen, do
deliver	deliver, arrive, die, happen, exist, appear, occur, fall, fail, delivery
suck	suck, die, bite, bleed, scream, vomit, drown, swallow, choke, move
test	fail, test, cheat, succeed, react, experiment, fall, respond, try, behave
ride	ride, fall, crash, move, die, hurt, jump, brake, suffer, fail
complete	succeed, complete, exist, fail, finish, occur, progress, work, die, change
face	appear, move, react, speak, fall, turn, attack, exist, flee, respond
smash	fall, break, hit, explode, smash, die, crash, harm, strike, move
run	run, fail, succeed, crash, fall, die, lose, stop, occur, happen
send	send, exist, respond, die, write, return, receive, appear, communicate, arrive
mean	exist, appear, occur, speak, change, die, happen, be, say, object
change	change, exist, appear, die, occur, happen, evolve, suffer, behave, transform
kick	fall, kick, die, move, hurt, jump, stop, hit, strike, flee
wing	wing, fly, attack, fight, do, die, behave, happen, fall, cross
hide	hide, disappear, appear, lie, flee, exist, escape, vanish, conceal, move
dig	dig, fall, die, move, collapse, sink, break, disappear, do, exist
sing	sing, scream, dance, stop, appear, perform, cry, laugh, shout, speak
mention	appear, speak, occur, respond, exist, reply, object, laugh, talk, comment
mail	mail, write, respond, send, exist, appear, die, reply, deliver, receive
announce	announce, appear, occur, speak, shout, react, happen, talk, exist, say
cook	cook, eat, die, starve, rise, stir, bake, perish, fail, suffer
fly	fly, fall, crash, land, fail, die, appear, explode, exist, disappear
clean	clean, behave, vomit, appear, live, vacuum, drink, smell, stink, work
stick	fall, hurt, move, bleed, hit, bite, stick, die, explode, break
cap	fall, crash, explode, die, disappear, laugh, move, jump, fail, collapse
order	order, act, behave, obey, fail, comply, object, do, intervene, occur
watch	watch, appear, react, move, see, stare, look, stop, laugh, observe
receive	receive, exist, occur, arrive, return, give, happen, respond, appear, die
sink	sink, drown, fall, die, swim, fail, rise, break, float, collapse
unlock	unlock, appear, exist, open, awaken, escape, die, enter, succeed, activate
wash	wash, vomit, shower, drown, appear, clean, flush, drink, rinse, change
achieve	succeed, achieve, occur, happen, exist, fail, accomplish, do, win, result
drive	drive, die, move, stop, crash, drink, accelerate, pass, fail, run
shut	shut, scream, close, stop, leave, speak, open, shout, break, run
fake	exist, lie, fake, appear, deceive, disappear, die, happen, occur, fall
notice	notice, appear, observe, react, blink, look, see, act, exist, move
turn	turn, change, move, die, fall, appear, transform, shift, do, happen
live	live, die, exist, survive, perish, suffer, occur, grow, death, life
spot	appear, move, notice, react, look, see, jump, exist, blink, run
afford	exist, live, pay, benefit, succeed, suffer, survive, buy, die, profit
walk	walk, fall, run, move, stop, stumble, cross, jump, step, appear
experience	experience, exist, occur, appear, happen, react, feel, act, perceive, suffer
bite	bite, die, bleed, fall, scream, attack, hurt, suffer, vomit, cry
allow	exist, suffer, occur, die, happen, intervene, succeed, act, benefit, live
move	move, fall, react, jump, change, appear, act, stop, leave, object
grow	grow, die, change, shrink, multiply, occur, appear, evolve, develop, reproduce
push	fall, move, push, object, stop, shove, react, fail, hurt, resist
google	google, search, exist, comment, stumble, appear, look, click, visit, disappear
leave	leave, depart, die, return, go, stay, disappear, flee, move, exist
shove	fall, shove, move, push, object, stumble, leave, jump, flee, laugh
choose	choose, exist, die, win, change, lose, occur, succeed, decide, act
shoot	die, shoot, kill, fire, fall, flee, explode, suffer, act, death
question	question, answer, respond, object, disagree, lie, act, speak, leave, react
pick	choose, pick, move, die, win, fall, change, object, fight, lose
deny	deny, refuse, resist, object, exist, fail, suffer, fight, lie, complain
join	join, leave, exist, die, fail, participate, follow, enter, go, succeed
witness	witness, see, appear, observe, occur, act, watch, react, speak, happen
demand	refuse, object, demand, comply, ask, stop, suffer, complain, act, disappear
follow	follow, lead, move, fall, die, act, leave, do, disappear, stop
require	fail, exist, occur, suffer, require, change, happen, act, appear, object
release	release, escape, die, exist, happen, suffer, occur, disappear, return, leave
decide	decide, act, choose, change, exist, die, do, happen, occur, move
kiss	kiss, blush, laugh, smile, cry, faint, respond, move, scream, fall
punch	fall, punch, strike, object, hit, scream, retaliate, hurt, move, fight
consider	think, exist, act, consider, react, respond, believe, occur, object, change
guarantee	die, exist, happen, fail, occur, succeed, kill, suffer, perish, appear
invent	exist, invent, appear, occur, evolve, arise, happen, develop, create, succeed
teach	learn, teach, fail, understand, speak, suffer, succeed, think, change, act
book	book, pay, appear, sue, exist, leave, call, act, cancel, do
wreck	crash, die, fall, wreck, happen, fail, occur, explode, break, suffer
refuse	refuse, object, resist, decline, reject, leave, fail, complain, ask, deny
plan	plan, happen, occur, act, succeed, fail, do, die, plot, exist
fuck	die, fuck, cum, orgasm, exist, reproduce, kill, suffer, rape, leave
ask	ask, answer, question, respond, object, speak, reply, act, react, talk
create	exist, occur, appear, happen, create, arise, evolve, change, die, disappear
pay	pay, die, work, suffer, leave, live, exist, act, appear, complain
match	exist, change, appear, match, evolve, differ, succeed, occur, reproduce, move
bottle	drink, drown, die, vomit, exist, explode, harm, eat, speak, attack
accomplish	occur, accomplish, happen, succeed, achieve, do, exist, appear, progress, work
bear	bear, die, exist, grow, suffer, live, conceive, perish, appear, fall
repeat	repeat, occur, continue, change, appear, speak, say, stop, happen, fail
meet	meet, exist, appear, occur, happen, arrive, die, come, interact, encounter
fold	fold, fall, break, bend, collapse, fail, drop, die, turn, move
hack	hack, die, attack, crash, fail, break, exist, succeed, happen, fall
help	suffer, help, succeed, benefit, live, improve, die, survive, intervene, exist
defend	suffer, fall, flee, die, attack, harm, succeed, lose, fight, retaliate
rock	fall, move, hurt, rock, cry, scream, break, explode, jump, stumble
guess	guess, answer, lie, think, respond, know, believe, succeed, move, fail
sense	sense, exist, perceive, move, appear, act, feel, react, know, notice
work	work, fail, do, succeed, act, perform, happen, operate, break, function
cover	fall, hide, appear, move, disappear, flee, lie, bleed, run, jump
sweat	sweat, cry, vomit, bleed, suffer, move, complain, drink, pee, sleep
paint	paint, appear, exist, color, die, change, disappear, move, bleed, fall
record	record, exist, appear, listen, occur, die, hear, speak, sound, suffer
confirm	exist, lie, confirm, die, occur, believe, appear, change, affirm, disagree
block	block, interfere, fail, intervene, stop, respond, move, object, appear, react
fire	fire, resign, quit, die, leave, fail, terminate, lose, retire, flee
fill	fill, exist, grow, empty, shrink, disappear, expand, appear, move, overflow
notch	fall, die, bite, jump, hit, hurt, fight, move, attack, strike
cross	cross, move, act, die, pass, jump, occur, fall, happen, transgress
screw	die, screw, lose, fail, exist, fuck, kill, hurt, fall, do
draw	draw, appear, exist, move, die, write, disappear, fall, happen, occur
declare	declare, exist, appear, die, lie, cease, occur, disappear, change, be
bake	bake, cook, rise, exist, eat, die, fail, fall, do, cry
replace	exist, disappear, change, die, occur, fail, perish, leave, cease, decline
spoil	spoil, suffer, die, fail, behave, complain, ruin, perish, starve, fall
quit	quit, leave, resign, fail, die, terminate, lose, retire, stop, succeed
provide	provide, exist, occur, give, benefit, do, appear, produce, help, perform
Google	google, search, exist, respond, ask, comment, visit, click, look, appear
spin	spin, turn, move, fall, change, break, happen, bend, swing, rise
hurt	harm, suffer, die, hurt, fall, injure, kill, attack, happen, retaliate
force	object, act, suffer, comply, behave, resist, leave, change, intervene, fail
lick	lick, vomit, bite, stop, move, spit, kiss, faint, scream, laugh
delete	delete, disappear, exist, vanish, die, appear, change, leave, post, occur
blame	blame, suffer, fail, lose, act, offend, die, lie, retaliate, harm
let	die, leave, suffer, go, fall, fail, escape, exist, happen, harm
melt	melt, freeze, explode, break, move, disappear, boil, fall, dissolve, react
lock	lock, escape, break, leave, enter, panic, flee, move, disappear, die
reject	reject, refuse, change, object, respond, leave, decline, exist, fail, die
pop	pop, explode, fall, die, drop, jump, fly, combust, erupt, hurt
play	play, die, appear, exist, act, move, speak, behave, suffer, lose
brew	brew, drink, boil, exist, produce, do, happen, occur, appear, create
shout	shout, yell, scream, laugh, cry, jump, speak, respond, stop, run
toss	fall, throw, toss, drop, object, move, leave, jump, lose, flee
seal	seal, break, fail, disappear, close, escape, dissolve, drown, fall, exist
patent	exist, patent, succeed, invent, die, innovate, appear, prosper, occur, produce
bury	die, perish, exist, live, disappear, suffer, fall, death, rise, kill
become	exist, change, appear, occur, die, evolve, happen, disappear, be, arise
rip	rip, fall, break, die, cut, tear, bite, snap, cry, bleed
cast	cast, fail, die, fall, appear, leave, lose, disappear, occur, act
marry	marry, die, live, exist, divorce, wed, conceive, reproduce, succeed, kill
realise	realise, notice, happen, exist, realize, understand, know, see, recognise, think
request	request, ask, object, respond, refuse, occur, appear, exist, comply, intervene
wipe	wipe, vomit, appear, pee, bleed, die, disappear, move, leave, occur
reach	exist, appear, occur, happen, speak, communicate, arrive, die, respond, succeed
ace	die, fall, exist, fail, succeed, attack, occur, suffer, lose, defect
define	exist, appear, change, occur, define, die, be, disappear, happen, differ
figure	figure, do, think, occur, appear, happen, solve, exist, die, be
fail	fail, succeed, die, fall, suffer, lose, perish, stumble, failure, exist
recommend	succeed, benefit, recommend, complain, suffer, believe, fail, change, improve, lie
confess	confess, lie, resign, confession, repent, sin, admit, die, disclose, testify
describe	exist, appear, occur, speak, be, happen, differ, change, behave, talk
execute	die, execute, kill, suffer, perish, act, exist, occur, death, happen
knock	fall, knock, stumble, trip, die, crash, drop, tumble, break, hit
sue	sue, die, suffer, lose, pay, succeed, flee, harm, retaliate, exist
cry	cry, weep, scream, sob, die, laugh, suffer, speak, crying, yell
scratch	scratch, fall, bite, hurt, bleed, strike, hit, move, cry, die
crash	crash, fall, fail, die, collide, occur, hit, happen, stop, explode
fry	fry, die, explode, choke, vomit, drown, starve, suffer, boil, eat
copy	copy, change, exist, reproduce, evolve, succeed, differ, appear, duplicate, behave
sling	fall, throw, hit, drop, swing, hurt, move, fight, scream, sling
made	die, exist, occur, appear, fall, suffer, happen, perish, move, live
swipe	swipe, fall, move, blink, disappear, appear, stumble, tap, jump, respond
cop	die, exist, kill, do, occur, reproduce, change, cross, happen, attack
design	exist, design, change, appear, succeed, evolve, occur, die, create, fail
celebrate	celebrate, rejoice, smile, exist, suffer, die, win, succeed, occur, triumph
collect	collect, disappear, exist, vanish, object, return, die, leave, appear, fall
produce	exist, occur, produce, appear, happen, arise, reproduce, grow, die, result
wield	wield, strike, move, attack, fight, fall, use, appear, harm, do
set	fall, rise, move, fail, do, set, happen, break, die, go
reveal	reveal, appear, lie, disappear, emerge, die, hide, exist, change, confess
remove	leave, disappear, appear, move, vanish, remove, exist, return, go, occur
surpass	succeed, win, improve, fail, prevail, lose, gain, advance, exist, fall
swear	swear, lie, curse, speak, spit, laugh, believe, vomit, die, drink
donate	donate, give, die, benefit, live, contribute, pay, receive, profit, exist
sort	sort, behave, act, separate, object, change, occur, fail, do, move
inherit	inherit, exist, die, occur, succeed, evolve, survive, arise, change, develop
prefer	prefer, change, win, exist, choose, differ, prevail, succeed, object, improve
snatch	flee, disappear, steal, fall, escape, vanish, leave, bite, snatch, jump
conquer	win, succeed, die, triumph, exist, prevail, dominate, fall, lose, conquer
protect	harm, die, suffer, flee, survive, perish, fall, exist, attack, fail
found	die, exist, occur, appear, fall, happen, perish, suffer, move, disappear
top	win, lose, succeed, fall, dominate, fail, rise, pass, beat, die
risk	die, risk, fall, fail, harm, suffer, perish, lose, flee, happen
leak	leak, defect, spill, drown, escape, explode, fail, slip, break, jump
ignore	ignore, exist, respond, disappear, object, react, act, complain, appear, leave
veto	veto, object, win, disagree, lose, die, act, fail, vote, change
did	die, exist, occur, fall, appear, suffer, happen, move, attack, react
discuss	speak, talk, disagree, respond, discuss, object, comment, argue, occur, react
coin	exist, die, appear, occur, change, fall, speak, move, disappear, fail
flush	flush, vomit, pee, drown, die, fart, move, jump, faint, fall
spend	spend, pay, lose, live, suffer, leave, exist, earn, die, gain
perfect	succeed, improve, fail, excel, exist, change, perfect, evolve, flourish, work
track	disappear, flee, move, run, vanish, appear, exist, hide, escape, die
retrieve	return, disappear, leave, retrieve, appear, vanish, object, fall, escape, exist
defeat	win, die, lose, succeed, triumph, defeat, prevail, fail, fall, perish
chuck	laugh, fall, vomit, throw, jump, drop, chuck, object, move, lose
float	float, fall, fly, move, rise, sink, land, jump, drop, drown
embrace	embrace, respond, hug, react, laugh, move, smile, flee, recoil, appear
hang	hang, fall, die, jump, kill, appear, disappear, rise, exist, suffer
return	return, leave, respond, exist, appear, go, flee, disappear, depart, object
manufacture	exist, manufacture, produce, appear, occur, reproduce, create, make, happen, work
flip	flip, turn, fall, switch, move, change, die, swing, jump, lose
resist	resist, fight, refuse, attack, object, respond, fail, stop, complain, suffer
scar	die, hurt, bleed, harm, suffer, fall, bite, cry, scar, react
overcome	succeed, overcome, win, triumph, prevail, exist, survive, fail, die, suffer
sniff	sniff, smell, jump, move, cough, bite, object, bark, stop, react
launch	launch, succeed, fail, exist, crash, explode, occur, happen, die, jump
drown	drown, die, perish, sink, fall, suffer, disappear, death, swim, drowned
forbid	fail, act, intervene, suffer, interfere, exist, offend, object, speak, forbid
got	die, exist, fall, occur, appear, suffer, happen, move, perish, attack
clear	clear, appear, leave, disappear, occur, die, move, flee, cross, speak
avoid	avoid, appear, flee, leave, react, exist, disappear, act, attack, escape
succeed	succeed, fail, win, exist, rise, improve, excel, triumph, survive, lose
put	fall, go, put, move, take, disappear, stop, leave, die, happen
edit	edit, change, exist, copy, write, fail, appear, break, delete, suffer
check	check, fail, cheat, look, stop, err, complain, act, occur, object
capture	flee, escape, disappear, die, vanish, capture, appear, fall, attack, leave
endure	suffer, endure, die, exist, survive, perish, live, fall, occur, prevail
bust	fall, bust, break, explode, fail, die, hurt, strike, stumble, collapse
seize	flee, seize, fall, disappear, move, escape, vanish, steal, die, resist
head	die, kill, head, exist, occur, run, fall, happen, death, perish
climb	fall, climb, jump, collapse, topple, move, die, rise, stumble, descend
decrypt	decrypt, encrypt, break, exist, communicate, decode, disappear, die, fail, execute
justify	exist, suffer, occur, act, succeed, lie, die, justify, appear, believe
master	master, succeed, dominate, change, evolve, improve, win, learn, excel, exist
implement	implement, fail, exist, work, occur, happen, change, do, function, succeed
introduce	appear, speak, exist, occur, respond, talk, intervene, react, enter, object
recover	recover, return, die, exist, fall, occur, survive, disappear, suffer, escape
light	light, burn, fire, smoke, ignite, glow, appear, explode, die, flame
promise	promise, lie, believe, happen, die, act, appear, refuse, exist, fail
hump	jump, die, vomit, move, hurt, fall, attack, bite, scream, fight
pack	pack, leave, flee, move, escape, explode, panic, eat, die, disappear
fit	fit, exist, appear, change, move, grow, deform, occur, form, be
support	benefit, succeed, exist, suffer, help, live, survive, die, act, support
resolve	resolve, exist, arise, occur, change, happen, settle, appear, die, disappear
supply	supply, produce, exist, fail, appear, work, occur, provide, consume, do
chew	chew, bite, bleed, eat, spit, fall, die, swallow, choke, break
slice	die, slice, bite, bleed, fall, cut, eat, suffer, choke, explode
lead	follow, lead, act, do, fall, occur, happen, go, believe, succeed
ship	ship, leave, move, sell, defect, trade, fail, arrive, exist, happen
tackle	fall, attack, fight, flee, move, intervene, stumble, harm, react, respond
prevent	occur, happen, fail, intervene, stop, act, succeed, suffer, react, exist
narrow	cross, change, narrow, lose, disappear, exist, grow, move, break, separate
fund	exist, succeed, benefit, die, fail, suffer, prosper, survive, live, profit
loose	loose, die, lose, leave, disappear, fall, perish, suffer, fail, escape
repair	repair, heal, function, work, improve, exist, survive, change, occur, live
milk	drink, die, milk, suffer, starve, eat, drown, kill, cry, scream
present	appear, present, exist, occur, object, disappear, fail, act, happen, behave
welcome	welcome, enter, arrive, appear, smile, return, come, leave, respond, exist
cure	die, live, exist, suffer, appear, improve, cure, recover, survive, heal
tweet	tweet, respond, retweet, reply, react, post, comment, retaliate, write, publish
beg	beg, ask, refuse, answer, die, leave, suffer, object, obey, disappear
wrap	wrap, fall, break, bind, move, disappear, collapse, slip, fold, jump
haunt	die, appear, disappear, attack, suffer, vanish, exist, return, fall, harm
stand	fall, stand, move, rise, walk, fight, jump, attack, stumble, run
pursue	pursue, exist, succeed, act, leave, occur, follow, object, desire, fail
fear	fear, panic, flee, attack, worry, die, suffer, harm, react, hesitate
brave	die, flee, fall, attack, perish, fight, survive, escape, suffer, exist
trust	trust, believe, lie, distrust, deceive, mistrust, act, behave, cooperate, do
cool	cool, react, sweat, die, explode, move, scream, do, exist, burn
recognise	appear, recognise, exist, move, respond, react, speak, recognize, notice, look
summon	appear, exist, attack, summon, arise, speak, awaken, die, manifest, occur
offer	offer, give, refuse, respond, pay, object, accept, leave, decline, act
shatter	shatter, break, fall, explode, collapse, fracture, dissolve, disappear, fail, crack
acknowledge	respond, acknowledge, speak, appear, exist, smile, reply, react, recognize, act
press	object, move, fall, resist, scream, push, react, respond, press, jump
honor	suffer, honor, rejoice, die, exist, live, benefit, smile, celebrate, worship
treasure	exist, suffer, die, steal, object, treasure, envy, hate, live, succeed
photograph	photograph, appear, exist, disappear, object, die, shoot, move, occur, pose
ban	object, disappear, exist, offend, leave, retaliate, fail, stop, act, harm
squash	squash, die, fall, disappear, explode, perish, exist, fail, attack, suffer
reap	die, exist, suffer, occur, fall, happen, fail, perish, succeed, eat
trade	trade, sell, leave, die, exist, defect, exchange, pay, lose, disappear
fuel	burn, exist, rise, die, occur, thrive, run, fire, explode, grow
forge	forge, break, exist, die, happen, fall, fail, occur, do, melt
forgive	forgive, repent, apologize, change, suffer, live, return, die, forget, understand
shred	shred, break, die, fall, explode, burn, cut, bleed, collapse, disappear
organize	organize, act, occur, succeed, exist, happen, do, behave, work, fail
rescue	die, escape, survive, flee, perish, live, intervene, fall, exist, appear
approve	approve, disapprove, act, succeed, change, exist, object, occur, agree, disagree
correct	correct, respond, complain, speak, react, fail, change, object, lie, err
study	study, learn, think, exist, suffer, behave, understand, appear, change, speak
whisper	shout, whisper, scream, speak, laugh, talk, hear, yell, cry, respond
raise	die, rise, succeed, fail, exist, grow, live, raise, suffer, fall
serve	serve, benefit, exist, suffer, succeed, act, die, function, fail, do
predict	predict, happen, occur, exist, succeed, appear, behave, act, react, change
erase	disappear, exist, vanish, appear, die, erase, change, return, occur, happen
document	exist, occur, document, appear, disappear, write, die, happen, change, record
needed	die, exist, occur, fall, appear, suffer, happen, move, react, perish
utter	speak, occur, shout, utter, say, scream, respond, appear, laugh, exist
control	suffer, behave, act, die, change, react, exist, control, fail, occur
nab	flee, fall, escape, steal, disappear, bite, attack, die, strike, grab
spit	spit, vomit, spew, scream, spat, bleed, laugh, bite, fire, swallow
DO	do, act, happen, occur, die, be, exist, fail, behave, work
contain	exist, occur, appear, move, disappear, form, contain, change, be, arise
rebuild	rebuild, collapse, exist, fall, survive, break, die, fail, occur, return
recall	recall, appear, remember, speak, occur, forget, think, respond, return, react
slit	die, fall, bleed, slit, bite, kill, cut, jump, death, suffer
look	look, appear, see, stare, blink, smile, react, move, turn, change
swim	swim, move, drown, exist, change, disappear, cross, die, jump, do
dream	dream, sleep, believe, exist, happen, die, think, occur, wish, appear
tame	die, suffer, grow, behave, flee, change, appear, attack, kill, fight
plug	plug, disconnect, run, fail, charge, die, move, work, collapse, connect
unleash	die, attack, unleash, explode, flee, happen, occur, appear, escape, react
cause	die, exist, happen, suffer, occur, act, react, appear, fall, behave
unveil	appear, exist, change, disappear, die, defect, transform, manifest, occur, vanish
ski	die, fall, ski, jump, move, exist, kill, crash, do, fight
expose	appear, expose, flee, lie, disappear, die, defect, suffer, hide, escape
foil	fail, flee, die, fall, succeed, cheat, foil, react, attack, lose
spell	appear, occur, exist, change, happen, speak, spell, fail, say, write
settle	settle, die, leave, marry, exist, live, suffer, fall, occur, change
worth	die, exist, fall, suffer, appear, occur, perish, move, live, happen
storm	flee, storm, leave, fall, attack, fight, intervene, appear, strike, explode
finance	exist, succeed, fail, die, occur, profit, prosper, survive, happen, benefit
waste	waste, die, fail, perish, consume, exist, suffer, live, use, lose
blast	explode, scream, die, react, fall, crash, jump, attack, retaliate, flee
tolerate	suffer, behave, exist, change, respond, tolerate, offend, retaliate, disagree, leave
better	improve, succeed, benefit, better, change, exist, excel, prosper, suffer, flourish
needs	die, exist, occur, fall, appear, suffer, happen, attack, move, perish
surf	surf, do, jump, crash, break, exist, move, occur, fall, cross
retake	die, fall, attack, occur, fail, move, exist, change, react, speak
dare	laugh, respond, fail, submit, retaliate, attack, fall, lose, object, fight
heal	heal, live, die, recover, suffer, exist, appear, survive, return, improve
crave	desire, crave, want, exist, suffer, hunger, resist, drink, wish, react
fetch	appear, return, arrive, flee, leave, disappear, object, fall, die, run
mind	mind, think, behave, stop, appear, forget, act, exist, listen, occur
hand	hand, die, appear, move, fall, give, object, drop, turn, do
come	come, appear, go, arrive, happen, occur, fall, die, be, pass
sew	sew, stitch, bleed, knit, die, wear, exist, fail, appear, sleep
enforce	act, fail, comply, change, obey, intervene, stop, object, exist, suffer
snap	snap, bite, scream, jump, fall, explode, break, hurt, hit, die
sneak	steal, flee, sneak, slip, escape, hide, disappear, cheat, fall, jump
wish	wish, die, happen, exist, believe, dream, occur, appear, succeed, desire
spike	spike, jump, explode, die, vomit, move, crash, react, happen, scream
thin	die, fall, move, exist, suffer, fail, appear, attack, harm, eat
judge	judge, suffer, think, act, disagree, complain, harm, behave, offend, react
race	win, race, lose, cheat, crash, succeed, die, compete, overtake, pass
arrange	arrange, occur, behave, appear, happen, move, act, do, change, order
bag	fall, stumble, die, hit, trip, fight, hurt, flee, jump, bite
voice	speak, shout, respond, scream, talk, voice, yell, exist, appear, say
hug	hug, cry, laugh, scream, respond, move, react, smile, fall, jump
split	split, separate, divide, break, die, fracture, divorce, fall, fail, change
film	appear, film, die, laugh, exist, shoot, suffer, flee, occur, jump
install	install, crash, fail, run, uninstall, work, appear, break, exist, boot
continue	continue, stop, cease, end, occur, die, proceed, fail, begin, change
hatch	hatch, exist, die, occur, arise, reproduce, appear, happen, develop, spawn
stub	die, fall, exist, appear, suffer, move, occur, react, attack, speak
whip	whip, fall, strike, suffer, lash, choke, snap, bite, cry, scream
speak	speak, talk, shout, say, respond, answer, laugh, hear, scream, appear
equal	equal, exist, increase, differ, change, grow, gain, occur, improve, succeed
thank	smile, respond, apologize, speak, laugh, pay, thank, appear, reply, complain
fork	fork, eat, die, move, fight, do, react, fall, bite, kill
drain	die, drown, drain, disappear, drink, overflow, sink, fail, bleed, suffer
shape	change, appear, move, exist, evolve, transform, grow, form, behave, act
skip	skip, jump, walk, fail, stop, run, pass, move, fall, miss
weigh	weigh, gain, fall, suffer, grow, rise, move, increase, weight, faint
butcher	die, kill, murder, suffer, eat, perish, starve, death, bite, butcher
proclaim	exist, appear, lie, change, speak, believe, occur, disappear, cease, die
recreate	exist, appear, occur, happen, change, reproduce, evolve, die, disappear, return
go	go, die, happen, do, fall, come, occur, leave, stop, be
type	type, write, occur, appear, exist, copy, happen, click, print, text
sail	sail, fly, occur, sink, cross, exist, leave, move, appear, fail
text	text, respond, reply, call, communicate, message, write, answer, tweet, talk
chance	chance, happen, occur, die, succeed, do, strike, appear, fail, fall
rape	die, rape, kill, suffer, flee, murder, exist, attack, occur, fall
die	die, live, perish, exist, death, suffer, kill, pass, dies, survive
score	score, lose, win, cheat, fall, die, succeed, fail, pay, forfeit
hunt	kill, die, attack, hunt, suffer, flee, exist, disappear, escape, harm
grasp	grasp, move, fall, object, grab, touch, jump, recoil, appear, react
adopt	adopt, exist, die, reproduce, change, succeed, defect, live, appear, disappear
legalize	legalize, exist, succeed, prosper, die, benefit, suffer, act, change, happen
pronounce	occur, appear, exist, speak, change, say, differ, happen, arise, sound
imagine	exist, appear, think, occur, happen, believe, dream, imagine, act, speak
exhaust	exhaust, die, fail, suffer, expire, perish, stop, quit, disappear, tire
slay	die, kill, fall, death, suffer, attack, fight, perish, flee, slay
upload	upload, download, disappear, appear, exist, post, edit, happen, delete, load
add	subtract, add, change, appear, exist, disappear, occur, increase, join, leave
patch	patch, change, fail, work, improve, jump, do, repair, heal, fall
police	act, intervene, behave, stop, exist, harm, suffer, police, arrest, die
rub	rub, touch, hurt, move, blush, fall, scratch, object, laugh, react
promote	succeed, exist, benefit, rise, promote, prosper, profit, flourish, suffer, thrive
restore	return, appear, exist, restore, recover, occur, live, function, happen, regenerate
reverse	change, occur, exist, reverse, happen, appear, die, evolve, disappear, behave
stab	die, fall, bleed, hurt, kill, attack, stab, suffer, harm, strike
suffer	suffer, die, suffering, harm, exist, perish, live, fall, fail, hurt
absorb	absorb, exist, change, disappear, appear, transform, react, occur, move, speak
pin	fall, pin, move, object, strike, hit, appear, stumble, drop, hurt
expect	expect, fail, behave, act, occur, react, believe, refuse, do, happen
lift	fall, lift, move, rise, drop, stand, jump, collapse, descend, fly
suggest	respond, appear, speak, act, think, occur, reply, suggest, change, object
begin	end, begin, stop, continue, cease, occur, finish, die, start, fail
curse	curse, laugh, shout, die, suffer, speak, complain, scream, cry, yell
dye	bleed, change, dye, die, color, appear, reproduce, do, happen, grow
charm	smile, appear, laugh, blush, respond, charm, cry, react, behave, kiss
submit	submit, exist, surrender, respond, succeed, appear, submission, comply, propose, perish
right	change, right, correct, behave, succeed, wrong, act, do, happen, suffer
pitch	pitch, sell, succeed, fail, win, lose, object, appear, pay, buy
endorse	succeed, benefit, exist, suffer, change, act, believe, win, lie, die
suspect	suspect, believe, act, lie, think, panic, behave, investigate, doubt, flee
strike	fall, strike, die, move, hurt, flee, hit, appear, attack, suffer
undo	die, change, happen, occur, do, fail, undo, suffer, fall, exist
translate	translate, speak, understand, appear, change, read, exist, interpret, fail, occur
attack	attack, die, harm, retaliate, flee, fall, fight, strike, kill, act
eliminate	die, disappear, exist, vanish, perish, appear, eliminate, occur, kill, change
decipher	understand, speak, appear, exist, communicate, interpret, read, think, talk, know
respect	respect, behave, exist, act, suffer, obey, object, respond, change, react
rename	change, rename, exist, appear, occur, disappear, die, name, differ, happen
bless	prosper, benefit, suffer, bless, succeed, live, rejoice, die, curse, sin
scream	scream, shout, yell, cry, jump, speak, laugh, sound, explode, screaming
download	download, copy, install, listen, upload, do, exist, downloads, file, run
wind	fall, fly, wind, die, break, strike, crash, run, blow, fail
email	email, respond, reply, write, communicate, call, exist, text, tweet, post
redeem	exist, change, succeed, die, improve, live, return, rise, appear, benefit
mark	appear, die, mark, exist, move, disappear, occur, fall, cross, pass
protest	protest, object, act, react, complain, suffer, respond, demonstrate, stop, intervene
rough	harm, die, hurt, fall, fight, attack, kill, suffer, bite, scream
dread	fear, dread, die, panic, worry, hate, exist, suffer, attack, despair
borrow	borrow, steal, lend, use, return, leave, appear, pay, change, exist
skin	die, bite, bleed, kill, suffer, death, harm, appear, eat, starve
challenge	respond, react, fail, lose, attack, fight, submit, disagree, object, fall
identify	appear, exist, identify, occur, move, disappear, die, speak, recognize, act
command	act, obey, behave, react, command, respond, move, do, speak, intervene
knit	knit, exist, wear, happen, die, break, occur, do, fail, stitch
license	license, exist, succeed, kill, fail, die, marry, operate, profit, do
tear	fall, tear, break, hurt, cry, bleed, die, suffer, harm, weep
blog	blog, post, comment, publish, write, visit, tweet, exist, blogs, appear
toast	toast, rise, speak, spit, eat, cry, shout, scream, vomit, react
resent	resent, hate, complain, retaliate, suffer, dislike, rage, anger, fight, object
fancy	kiss, behave, flirt, smile, blush, exist, cheat, marry, appear, love
analyze	analyze, think, react, act, respond, suffer, behave, exist, change, occur
shoulder	fall, stumble, move, drop, cry, hit, jump, recoil, hurt, fight
LOVE	love, hate, exist, die, suffer, be, change, like, smile, respond
apply	apply, occur, appear, exist, change, happen, act, object, stop, work
for	exist, die, occur, happen, suffer, do, appear, fail, object, fall
tie	fall, die, tie, break, bind, jump, move, escape, hurt, suffer
dismiss	dismiss, leave, complain, respond, object, speak, fail, exist, disappear, disagree
trigger	react, act, occur, happen, trigger, respond, panic, appear, die, behave
freeze	freeze, die, melt, flee, move, fall, scream, disappear, react, panic
salvage	die, survive, perish, fall, exist, suffer, salvage, happen, fail, occur
deploy	deploy, fail, move, activate, respond, react, exist, occur, flee, fire
oppose	oppose, exist, attack, succeed, suffer, act, object, fight, fail, prevail
disclose	disclose, lie, reveal, know, deceive, hide, report, confess, occur, exist
cancel	cancel, die, exist, disappear, occur, vanish, fail, change, terminate, stop
land	land, exist, succeed, arrive, die, win, fall, leave, occur, fly
admire	admire, smile, envy, laugh, respond, react, love, hate, behave, exist
validate	exist, change, validate, succeed, lie, occur, disagree, believe, act, respond
revive	die, revive, live, exist, appear, return, awaken, regenerate, rise, recover
interpret	interpret, think, act, speak, believe, react, change, appear, occur, object
swing	swing, fall, strike, hit, move, hurt, object, injure, break, harm
choke	choke, die, faint, bleed, fall, scream, suffer, vomit, death, fight
decode	decode, speak, communicate, understand, exist, change, defect, talk, break, appear
sport	exist, die, occur, appear, attack, fall, harm, suffer, fight, speak
GET	die, exist, fall, suffer, occur, appear, react, move, happen, attack
scrap	scrap, scrape, fall, crash, break, scratch, strike, harm, move, rip
don	appear, wear, do, eat, exist, die, sleep, dress, don, be
sleep	sleep, die, wake, fall, awaken, rest, move, do, awake, lie
shake	shake, move, fall, react, scream, jump, cry, recoil, object, laugh
hope	hope, believe, die, exist, happen, succeed, wish, despair, occur, fail
sabotage	fail, die, suffer, defect, sabotage, fall, harm, succeed, perish, disappear
trash	trash, retaliate, complain, leave, harm, lose, offend, object, suffer, insult
slap	scream, slap, fall, cry, laugh, shout, hit, retaliate, object, strike
had	die, exist, occur, fall, appear, happen, suffer, move, perish, attack
log	log, happen, record, disappear, occur, run, exist, delete, crash, post
vomit	vomit, die, spit, cough, drink, drown, jump, choke, gag, vomiting
last	die, perish, survive, exist, fall, suffer, last, occur, fail, disappear
process	process, react, occur, act, behave, respond, think, happen, exist, move
plant	plant, appear, grow, die, occur, move, exist, fall, seed, happen
develop	develop, evolve, change, exist, grow, occur, appear, arise, progress, happen
murder	die, kill, murder, exist, death, perish, suffer, live, disappear, fall
spring	spring, fall, occur, appear, jump, happen, die, arise, rise, attack
mend	mend, improve, heal, live, change, exist, suffer, succeed, return, break
seek	seek, exist, flee, appear, leave, vanish, attack, disappear, occur, harm
cherish	love, suffer, exist, hate, die, rejoice, cherish, dislike, care, object
stink	stink, smell, vomit, fart, scream, drink, smoke, suffer, explode, die
maintain	exist, change, occur, remain, continue, evolve, prevail, maintain, cease, disappear
yell	yell, shout, scream, laugh, cry, respond, react, speak, stop, object
encourage	succeed, act, respond, behave, react, do, change, intervene, benefit, participate
back	fall, lose, fail, move, die, return, back, succeed, attack, run
repeal	exist, change, die, disappear, occur, fail, perish, succeed, happen, appear
NEED	exist, need, suffer, die, happen, want, occur, cry, hurt, be
roll	roll, fall, move, die, hit, drop, stumble, tumble, jump, slip
measure	measure, grow, move, increase, rise, weigh, change, exist, fall, differ
click	click, jump, move, blink, crash, interact, react, fall, appear, respond
tweak	change, fail, suffer, react, behave, break, crash, improve, tweak, malfunction
carve	bleed, die, fall, carve, break, appear, exist, move, cut, disappear
nick	nick, bite, fight, bleed, hurt, die, scratch, hit, occur, cry
rule	rule, prevail, exist, succeed, dominate, win, change, die, fail, fall
reclaim	return, exist, disappear, occur, die, leave, change, vanish, appear, fall
sustain	exist, survive, live, die, grow, thrive, continue, flourish, suffer, occur
express	exist, occur, appear, speak, express, happen, change, say, act, respond
burst	burst, break, explode, rupture, fall, shatter, collapse, fracture, fail, crack
practice	practice, perform, do, occur, act, work, behave, fail, improve, happen
bend	bend, fall, break, move, turn, twist, change, fold, hurt, swing
deserved	die, exist, suffer, fall, appear, occur, perish, happen, move, react
disguise	appear, deceive, exist, disappear, hide, defect, lie, disguise, change, occur
damn	die, suffer, sin, kill, harm, curse, fail, death, lose, exist
represent	exist, appear, occur, change, speak, happen, be, arise, move, act
perform	perform, act, occur, happen, do, appear, fail, exist, die, behave
rent	rent, leave, pay, exist, sell, live, buy, steal, borrow, move
charge	pay, charge, suffer, sue, lose, flee, complain, die, fail, retaliate
owe	owe, pay, suffer, borrow, die, repay, complain, debt, give, exist
gain	gain, lose, suffer, win, fall, die, benefit, succeed, leave, fail
outlaw	exist, outlaw, disappear, cease, perish, fail, die, object, stop, harm
store	store, exist, move, disappear, lose, break, hide, occur, hold, be
bluff	bluff, lie, fall, laugh, deceive, lose, mislead, cheat, succeed, win
count	count, fall, die, exist, occur, stop, rise, increase, decrease, appear
pocket	pay, steal, pocket, disappear, vanish, object, strike, fall, move, lose
frame	exist, frame, object, fall, appear, lie, act, disappear, die, offend
review	react, change, fail, complain, disagree, respond, object, occur, exist, suffer
demonstrate	demonstrate, appear, act, respond, react, behave, occur, speak, exist, show
dominate	dominate, lose, win, suffer, succeed, die, prevail, rule, exist, fight
rain	fall, drown, rain, cry, appear, drink, die, vomit, fly, shout
topple	fall, topple, collapse, fail, rise, crumble, die, stumble, crash, break
improve	improve, succeed, change, benefit, suffer, grow, progress, flourish, better, excel
convert	convert, change, die, repent, believe, sin, exist, defect, conversion, perish
horn	die, exist, fall, suffer, appear, occur, move, attack, perish, react
weather	die, exist, fall, suffer, occur, appear, attack, happen, speak, react
slow	slow, stop, accelerate, speed, move, fall, fail, react, stumble, die
curl	curl, fall, move, break, collapse, grow, jump, hurt, combust, react
volunteer	volunteer, serve, do, exist, die, give, work, participate, contribute, happen
research	exist, research, study, investigate, know, think, behave, occur, do, die
not	exist, be, occur, appear, fail, change, differ, behave, die, object
laugh	laugh, smile, chuckle, cry, scream, cough, yell, shout, laughter, speak
counter	respond, fail, counter, lose, attack, succeed, react, retaliate, fall, disagree
breathe	breathe, breath, cough, die, move, speak, smoke, scream, exist, laugh
gut	die, fall, bite, kill, snap, suffer, bleed, drown, collapse, explode
grill	retaliate, attack, vomit, die, fall, grill, scream, fight, choke, jump
feed	eat, starve, die, feed, suffer, hunger, live, vomit, exist, drink
abuse	abuse, suffer, harm, behave, leave, die, hurt, act, fight, attack
bore	die, suffer, perish, weep, cry, starve, bleed, death, conceive, complain
obtain	obtain, exist, occur, acquire, arise, happen, produce, appear, receive, succeed
swell	swell, grow, shrink, fall, die, drown, suffer, move, rise, occur
snag	fall, grab, disappear, jump, bite, escape, appear, happen, vanish, occur
ice	die, cry, react, freeze, fall, scream, eat, hurt, move, jump
repay	repay, pay, return, die, suffer, live, benefit, act, exist, behave
wave	wave, move, respond, gesture, blink, speak, laugh, appear, turn, react
lack	exist, lack, fail, disappear, lose, be, appear, suffer, possess, have
power	power, succeed, rise, exist, die, happen, suffer, win, dominate, occur
desire	desire, exist, object, wish, want, love, lust, seek, act, choose
clone	die, exist, clone, reproduce, change, evolve, appear, disappear, occur, defect
pipe	die, speak, exist, occur, fall, fail, do, happen, explode, talk
grade	fail, grade, fall, suffer, score, graduate, improve, pass, decline, succeed
adore	love, hate, exist, suffer, smile, die, dislike, laugh, despise, envy
soften	soften, change, move, react, hurt, suffer, break, fall, speak, smile
propose	propose, exist, appear, change, occur, proposal, happen, succeed, suggest, object
nails	die, exist, fall, appear, suffer, occur, move, perish, attack, react
saw	die, exist, appear, fall, occur, move, happen, attack, speak, react
paddle	paddle, fall, drown, object, move, strike, stroke, trip, fight, hit
direct	act, speak, react, respond, behave, intervene, think, occur, move, appear
escape	escape, flee, disappear, leave, appear, die, fall, exit, exist, enter
smack	smack, scream, fall, hit, slap, shout, stumble, strike, move, retaliate
wet	wet, vomit, pee, drink, drown, cry, bleed, dry, piss, fall
initiate	initiate, occur, happen, act, react, respond, intervene, begin, exist, appear
jump	jump, fall, leap, die, move, drop, crash, fail, run, explode
replicate	reproduce, exist, replicate, change, appear, evolve, occur, happen, behave, grow
contribute	contribute, benefit, work, participate, pay, give, do, exist, produce, gain
retire	retire, die, disappear, leave, decline, perish, succeed, exist, change, suffer
host	host, arrive, exist, visit, appear, behave, occur, come, live, stay
refute	disagree, lie, believe, refute, respond, fail, fall, exist, differ, reply
underestimate	lose, fail, underestimate, fall, suffer, succeed, win, gain, rise, lie
surrender	surrender, die, flee, submit, disarm, yield, leave, disappear, defect, comply
intercept	intercept, flee, interfere, fail, intervene, act, occur, disappear, stop, respond
detect	appear, exist, detect, react, notice, act, move, respond, occur, know
compile	compile, exist, occur, break, happen, crash, fail, change, multiply, stop
load	load, reload, crash, fail, explode, drop, run, fall, move, do
ditch	leave, die, change, fail, defect, lose, disappear, go, depart, marry
mount	mount, fall, jump, climb, move, rise, appear, attack, suffer, fight
arrest	flee, arrest, die, appear, disappear, escape, suffer, leave, act, stop
lament	die, exist, suffer, complain, occur, cry, defect, perish, change, fall
embody	exist, appear, change, occur, evolve, be, arise, act, manifest, speak
regain	return, die, occur, exist, lose, appear, regain, recover, fall, gain
about	exist, complain, occur, change, happen, harm, appear, behave, suffer, react
abandon	die, leave, abandon, fail, perish, flee, depart, disappear, defect, suffer
exploit	exploit, suffer, exist, die, attack, fail, benefit, succeed, harm, fall
on	fall, die, harm, attack, move, hurt, hit, react, happen, suffer
inspire	succeed, act, exist, believe, appear, think, occur, live, happen, rise
engineer	exist, fail, succeed, occur, evolve, die, happen, crash, change, work
enable	succeed, exist, occur, benefit, happen, act, do, appear, live, behave
rewrite	change, exist, rewrite, fail, occur, write, break, appear, happen, die
note	write, notice, note, appear, object, occur, respond, exist, stop, happen
recite	recite, speak, stop, respond, talk, say, repeat, laugh, appear, answer
enter	enter, leave, exit, pass, flee, escape, appear, depart, go, exist
talk	talk, speak, shout, stop, listen, respond, laugh, think, move, scream
trumpet	die, exist, fall, appear, suffer, occur, speak, move, attack, react
scrape	scrape, fall, scratch, bleed, hurt, hit, bite, strike, harm, move
dodge	dodge, move, evade, collide, fall, miss, cross, pass, deflect, jump
with	exist, die, occur, harm, suffer, cross, fight, interact, hurt, interfere
debate	disagree, argue, debate, lose, respond, speak, fight, differ, reply, object
remake	change, exist, appear, happen, die, evolve, occur, disappear, succeed, return
refine	change, exist, fail, occur, succeed, improve, evolve, die, differ, grow
guard	fall, flee, die, fail, harm, attack, move, suffer, retreat, escape
secure	die, flee, secure, exist, fall, fail, suffer, occur, act, disappear
chase	chase, flee, run, jump, disappear, attack, stop, fall, move, die
verify	lie, verify, exist, believe, deceive, die, fail, testify, appear, doubt
mourn	mourn, die, suffer, cry, weep, grief, exist, rejoice, decline, perish
permit	exist, occur, act, succeed, suffer, appear, happen, benefit, intervene, do
LIKE	die, exist, fall, appear, suffer, occur, react, move, attack, speak
time	time, die, occur, delay, happen, stop, do, fail, appear, clock
sack	resign, sack, leave, lose, strike, go, fail, suffer, quit, disappear
address	respond, speak, reply, react, object, answer, appear, talk, laugh, act
sacrifice	die, suffer, sacrifice, perish, exist, live, fall, death, kill, disappear
duplicate	duplicate, exist, change, differ, appear, occur, reproduce, disappear, replicate, evolve
sponsor	succeed, benefit, exist, sponsor, donate, win, profit, work, suffer, invest
spread	spread, propagate, disperse, rise, exist, grow, happen, appear, occur, multiply
assume	assume, exist, lie, believe, occur, appear, presume, happen, disappear, act
explode	explode, burst, explosion, erupt, combust, die, crash, occur, exploded, collapse
slam	fall, slam, hit, stumble, crash, object, retaliate, strike, hurt, break
dunk	drown, dunk, fall, die, sink, vomit, crash, bleed, jump, swim
cheer	cheer, smile, laugh, rejoice, cry, rise, celebrate, win, react, succeed
divide	divide, separate, split, differ, multiply, lose, exist, die, suffer, fall
best	succeed, win, die, fail, exist, lose, improve, suffer, fall, triumph
warrant	exist, occur, happen, die, arise, kill, do, appear, cease, act
dissect	die, suffer, explode, bleed, fall, exist, eat, vomit, death, perish
uncover	appear, exist, die, disappear, discover, occur, uncover, reveal, happen, flee
seem	appear, change, behave, act, seem, exist, be, disappear, react, look
resurrect	die, exist, live, appear, return, resurrect, rise, regenerate, revive, perish
zip	zip, jump, fly, die, flee, fall, choke, escape, explode, snap
air	speak, air, die, talk, breathe, yell, shout, explode, appear, scream
pour	drink, pour, fall, vomit, cry, drown, flow, spill, drop, overflow
rethink	change, exist, occur, react, think, disagree, happen, do, appear, differ
approach	approach, appear, move, respond, object, intervene, act, react, attack, leave
wrench	fall, move, jump, break, wrench, hurt, object, turn, swing, react
investigate	investigate, act, exist, occur, attack, appear, intervene, disappear, behave, die
crown	die, exist, succeed, marry, appear, crown, reign, rise, triumph, win
iron	die, fall, exist, suffer, appear, move, occur, react, attack, happen
misuse	misuse, harm, fail, use, abuse, suffer, behave, occur, cheat, fall
ink	bleed, die, move, bite, fight, scream, exist, blink, draw, write
shed	shed, die, disappear, appear, change, grow, lose, leave, exist, bleed
phone	call, answer, respond, phone, ring, text, speak, dial, die, talk
fumble	die, fall, exist, move, appear, suffer, attack, react, speak, occur
mix	mix, collide, occur, differ, overlap, separate, cross, change, exist, react
makes	exist, die, occur, happen, appear, suffer, move, fall, change, be
suffice	exist, die, occur, appear, suffer, fall, happen, perish, fail, speak
award	win, succeed, die, lose, fail, exist, triumph, celebrate, benefit, suffer
tap	tap, move, respond, touch, react, fall, appear, speak, stop, object
advertise	advertise, exist, appear, sell, succeed, lie, mislead, occur, disappear, deceive
determine	exist, change, occur, appear, be, determine, die, differ, arise, happen
retweet	retweet, tweet, respond, reply, post, share, react, comment, follow, publish
withstand	fall, die, attack, exist, suffer, fail, break, occur, react, move
explore	explore, investigate, exist, occur, move, do, interact, engage, act, change
dismantle	collapse, break, dismantle, disappear, fall, die, dissolve, explode, destroy, perish
visualize	appear, exist, see, move, think, visualize, react, occur, look, act
boycott	boycott, suffer, object, retaliate, lose, exist, offend, act, fail, harm
digest	digest, eat, die, exist, grow, fall, respond, occur, react, consume
include	exist, appear, occur, disappear, overlap, change, differ, object, include, happen
argue	argue, disagree, lose, respond, fight, reply, argument, win, complain, dispute
preserve	perish, exist, survive, die, disappear, suffer, live, preserve, occur, change
foot	fall, cross, eat, die, foot, walk, move, bite, pay, run
qualify	qualify, exist, pass, appear, succeed, fail, apply, fall, occur, benefit
inject	die, inject, overdose, bleed, kill, explode, react, combust, occur, exist
encounter	appear, exist, occur, encounter, react, interact, happen, move, act, object
dispute	dispute, disagree, object, argue, complain, differ, leave, fight, lose, sue
shine	shine, appear, glow, smile, fall, rise, blush, fail, look, fly
commit	commit, die, act, murder, exist, happen, kill, occur, do, fall
MAKE	exist, happen, die, change, be, move, appear, occur, do, suffer
cost	suffer, die, pay, lose, fail, fall, cost, exist, spend, increase
bang	fall, hit, hurt, object, die, bleed, explode, bang, strike, stumble
appropriate	object, occur, behave, act, react, offend, exist, respond, do, appear
implant	implant, exist, die, occur, appear, change, evolve, develop, reproduce, function
ring	ring, call, answer, respond, appear, panic, speak, talk, dial, phone
chant	chant, shout, sing, stop, scream, speak, yell, occur, dance, cry
hail	hail, laugh, appear, exist, die, flee, succeed, win, attack, fall
cement	die, exist, occur, fall, appear, suffer, happen, move, perish, change
knew	exist, die, kill, know, occur, happen, do, be, appear, speak
bar	retaliate, leave, intervene, object, fight, attack, drink, offend, yell, harm
chop	chop, fall, cut, choke, bite, die, bleed, break, scream, snap
fulfill	exist, fulfill, happen, occur, succeed, live, satisfy, perform, act, work
gift	give, gift, receive, die, behave, smile, benefit, exist, suffer, live
switch	switch, change, shift, move, flip, occur, jump, turn, happen, do
stain	stain, bleed, appear, drink, vomit, fall, burn, die, break, drown
shorten	shorten, stop, grow, change, speak, occur, cease, appear, suffer, pause
form	form, exist, occur, appear, arise, grow, happen, change, develop, emerge
stomach	die, vomit, fall, eat, suffer, attack, perish, fight, bleed, move
purchase	purchase, buy, sell, exist, acquire, occur, pay, consume, die, profit
hire	hire, work, exist, succeed, leave, pay, fire, act, resign, kill
twist	twist, move, turn, change, fall, bend, break, die, happen, suffer
mine	mine, exist, steal, work, die, produce, do, create, sell, use
bomb	explode, die, attack, bomb, fall, kill, flee, retaliate, strike, harm
salute	salute, smile, laugh, react, cheer, respond, applaud, recoil, appear, act
trademark	exist, occur, differ, change, appear, succeed, object, disappear, fail, happen
crank	crank, move, scream, laugh, explode, react, cry, jerk, spin, knock
done	die, exist, happen, occur, do, fall, kill, react, attack, suffer
style	style, appear, look, change, succeed, exist, wear, object, do, fall
boil	boil, drown, explode, die, cook, burn, melt, drink, rise, stir
gets	die, exist, fall, occur, suffer, appear, happen, move, perish, attack
enlarge	grow, enlarge, increase, shrink, change, appear, exist, expand, multiply, disappear
overlook	fail, fall, misunderstand, occur, overlook, err, stumble, appear, suffer, react
articulate	speak, exist, occur, understand, appear, talk, communicate, respond, say, think
pump	pump, bleed, move, vomit, explode, jump, rise, die, stop, stroke
won	die, exist, fall, appear, occur, suffer, happen, move, perish, react
slip	slip, fall, escape, lose, fail, disappear, appear, steal, stumble, cheat
said	exist, speak, occur, happen, say, talk, appear, die, react, do
hammer	fall, hit, strike, hurt, object, die, explode, break, attack, suffer
merit	exist, occur, die, suffer, succeed, happen, perish, appear, arise, fail
fall	fall, die, happen, fell, drop, fail, collapse, occur, break, do
file	file, fail, complain, fire, exist, sue, occur, write, change, lose
clutch	fall, bite, clutch, move, jump, hit, hurt, object, grab, react
hook	exist, happen, succeed, jump, move, marry, appear, die, occur, fall
of	die, exist, occur, fall, kill, suffer, harm, happen, attack, be
chip	chip, bite, fall, die, move, choke, attack, jump, hurt, break
display	display, appear, exist, react, occur, object, show, behave, disappear, see
lost	die, lose, disappear, perish, fall, exist, vanish, suffer, fail, go
coach	lose, win, succeed, coach, fail, play, improve, quit, cheat, score
bet	lose, bet, win, die, fail, pay, invest, lie, succeed, fall
mouth	speak, laugh, scream, shout, vomit, spit, mouth, respond, smile, cry
ensure	die, fail, happen, occur, kill, exist, suffer, succeed, perish, intervene
flash	flash, blink, react, scream, explode, appear, blush, jump, move, bleed
possess	exist, possess, appear, be, occur, live, suffer, reproduce, die, arise
picture	appear, exist, think, move, smile, react, see, laugh, happen, occur
suit	change, exist, appear, succeed, behave, suffer, benefit, flourish, occur, differ
lay	fall, die, lay, lie, exist, occur, sleep, move, live, marry
sound	sound, speak, scream, laugh, occur, shout, hear, say, respond, sing
organise	organise, act, occur, fail, intervene, behave, happen, exist, work, succeed
reopen	die, exist, fall, appear, suffer, occur, move, react, attack, speak
pinch	hurt, bite, fall, scream, move, object, choke, cry, react, laugh
tip	tip, lose, pay, fall, win, cheat, fail, complain, steal, err
administer	administer, die, suffer, intervene, occur, behave, fail, exist, act, appear
double	double, multiply, die, fail, cross, fall, exist, lose, increase, change
rescind	die, exist, occur, appear, suffer, fall, perish, happen, attack, disappear
scale	fall, scale, jump, grow, move, climb, fail, drop, leap, rise
does	die, exist, occur, fall, appear, suffer, happen, attack, move, react
heat	heat, burn, boil, fire, cook, combust, melt, rise, freeze, react
strut	die, fall, exist, appear, occur, move, suffer, react, speak, object
agree	agree, disagree, differ, act, change, argue, cooperate, move, object, leave
snow	fall, die, move, snow, flee, jump, disappear, appear, freeze, crash
search	search, look, disappear, object, vanish, exist, appear, leave, fail, seek
calculate	calculate, occur, increase, exist, compute, rise, change, pay, lie, zero
grind	grind, fall, die, bleed, break, hurt, move, cry, suffer, explode
deserves	die, exist, suffer, fall, occur, appear, perish, happen, live, move
shovel	shovel, fall, move, happen, do, jump, knock, dig, eat, die
activate	activate, appear, react, act, occur, respond, exist, attack, move, happen
strengthen	weaken, strengthen, grow, succeed, rise, suffer, change, increase, improve, fall
attain	exist, occur, succeed, attain, fall, happen, arise, gain, die, appear
reinvent	change, exist, evolve, appear, succeed, occur, die, disappear, transform, arise
grate	die, fall, exist, suffer, appear, move, occur, speak, attack, react
happen	happen, occur, exist, appear, do, die, act, come, change, happened
SEE	see, appear, look, move, exist, perceive, react, blink, act, notice
generate	exist, arise, occur, appear, happen, generate, evolve, produce, create, grow
rap	cry, fight, fall, rap, die, scream, hit, exist, laugh, speak
wonder	exist, appear, occur, disappear, do, happen, die, laugh, harm, suffer
torch	die, burn, explode, fire, fall, perish, flee, scream, attack, jump
down	die, fall, suffer, attack, harm, fail, kill, fight, succeed, move
visit	visit, appear, exist, return, die, occur, come, leave, arrive, enter
ID	appear, exist, identify, id, recognize, die, disappear, respond, move, act
surprise	surprise, react, laugh, smile, appear, occur, think, die, happen, respond
rush	delay, rush, fail, jump, fall, stop, react, run, accelerate, crash
debunk	exist, believe, lie, succeed, die, fail, disagree, fall, appear, occur
muscle	move, fall, die, fight, suffer, attack, hurt, choke, fail, hit
condemn	suffer, die, perish, offend, exist, fall, act, fail, defect, flee
peel	peel, bite, die, fall, eat, move, strip, hurt, boil, do
starve	starve, die, suffer, perish, death, eat, hunger, starvation, disappear, famine
clinch	die, fall, exist, appear, suffer, move, occur, react, attack, speak
concede	concede, lose, die, fall, defect, exist, surrender, leave, win, change
employ	work, employ, succeed, exist, hire, act, benefit, leave, fail, pay
consume	consume, eat, die, drink, exist, suffer, vomit, perish, occur, starve
shrink	shrink, grow, change, disappear, move, suffer, die, enlarge, weaken, diminish
invite	appear, come, invite, arrive, ask, visit, enter, attend, leave, occur
guide	succeed, move, act, speak, appear, walk, behave, follow, intervene, do
poop	poop, pee, fart, vomit, die, happen, go, shit, occur, dump
honour	die, suffer, honour, exist, live, benefit, rejoice, smile, offend, celebrate
fish	fish, bite, die, drown, kill, eat, swim, spawn, attack, move
flavor	die, react, vomit, speak, change, appear, drink, exist, eat, move
bridge	cross, fall, move, exist, break, die, speak, occur, happen, fail
juice	die, vomit, drink, eat, jump, explode, bleed, kill, move, scream
convince	believe, succeed, act, think, change, appear, lie, convert, leave, flee
wire	wire, die, jump, communicate, call, do, connect, run, fire, interfere
warm	warm, freeze, move, melt, cold, rise, sleep, react, heat, breathe
embarrass	suffer, laugh, behave, act, embarrass, appear, blush, speak, react, fail
bike	bike, bicycle, die, ride, crash, do, knock, hit, attack, exist
bowl	bowl, fall, hit, lose, object, throw, fail, vomit, stumble, choke
compose	exist, compose, occur, appear, write, arise, sound, form, happen, evolve
graduate	graduate, succeed, fail, die, exist, change, fall, leave, decline, grow
making	die, exist, occur, happen, fall, suffer, appear, change, move, fail
expand	expand, grow, increase, change, shrink, multiply, exist, evolve, decrease, enlarge
sketch	sketch, appear, exist, draw, move, smile, write, paint, laugh, disappear
furnish	exist, appear, live, furnish, produce, suffer, perish, do, arise, give
dislike	dislike, hate, complain, object, suffer, exist, change, act, retaliate, behave
preach	preach, believe, lie, suffer, speak, convert, offend, die, listen, perish
acquire	acquire, exist, occur, appear, evolve, die, obtain, perish, change, arise
park	park, move, stop, drive, crash, leave, occur, appear, fall, brake
in	exist, occur, die, fall, change, happen, move, suffer, harm, react
prepare	prepare, suffer, react, fail, die, rise, do, occur, panic, perish
stone	die, kill, fall, suffer, fight, hurt, stone, scream, harm, attack
authorize	act, exist, die, intervene, occur, kill, appear, do, happen, interfere
rank	rank, fall, rise, win, lose, score, suffer, improve, succeed, exist
stretch	stretch, fall, move, bend, suffer, hurt, contract, grow, shrink, yawn
poison	die, suffer, kill, overdose, death, poison, perish, drink, vomit, harm
scrub	vomit, scrub, scratch, spit, scrape, strip, move, appear, scream, rub
feather	fall, die, fly, strike, fight, attack, hurt, bite, feather, bleed
grant	exist, succeed, live, benefit, happen, give, grant, die, receive, occur
tow	fall, move, fight, tow, jump, cross, do, object, walk, flee
bung	die, fall, exist, occur, appear, suffer, fail, attack, move, happen
will	do, happen, die, exist, behave, will, suffer, kill, wish, move
shave	shave, die, appear, bleed, disappear, bite, kill, change, cut, death
after	die, fall, happen, harm, kill, attack, appear, occur, suffer, disappear
trick	cheat, lie, fall, die, deceive, fail, succeed, act, behave, laugh
doing	die, do, happen, occur, exist, act, stop, harm, fail, behave
stir	stir, react, drink, move, rise, scream, awaken, jump, appear, shout
confront	respond, flee, react, attack, fight, act, intervene, object, retaliate, leave
assemble	assemble, break, occur, exist, move, collapse, fail, build, object, appear
comprehend	understand, comprehend, speak, think, exist, respond, know, perceive, communicate, talk
collapse	collapse, fall, fail, break, crumble, topple, crash, dissolve, fracture, explode
bump	fall, bump, trip, stumble, collide, move, hit, crash, jump, knock
stagger	die, fall, move, appear, exist, suffer, occur, react, speak, attack
stitch	stitch, knit, sew, fall, bleed, hurt, suffer, break, cut, appear
restart	restart, crash, reboot, fail, stop, run, die, start, quit, boot
lower	fall, rise, suffer, drop, lower, die, decline, complain, move, fail
bank	die, exist, occur, fall, suffer, appear, happen, fail, move, perish
nut	die, exist, fall, suffer, appear, occur, move, perish, attack, react
shift	shift, change, move, occur, turn, happen, do, switch, react, act
applaud	applaud, laugh, cheer, smile, respond, react, shout, cry, yell, speak
liberate	escape, liberate, suffer, die, exist, flee, live, fall, perish, revolt
dot	move, appear, cross, object, exist, die, multiply, disappear, jump, occur
disable	die, malfunction, fail, disable, suffer, disappear, occur, crash, appear, stop
eradicate	die, disappear, exist, perish, appear, return, vanish, occur, suffer, happen
overturn	change, fall, fail, occur, overturn, happen, exist, succeed, prevail, collapse
bleed	bleed, die, drown, suffer, death, vomit, cry, fall, kill, hurt
issue	occur, respond, react, strike, object, fail, issue, attack, appear, die
size	grow, shrink, size, move, change, gain, eat, increase, appear, weigh
glue	glue, jump, fall, break, move, bind, hurt, snap, bite, bleed
struggle	struggle, fight, suffer, fall, resist, fail, die, stumble, move, succeed
unravel	unravel, collapse, disappear, break, die, fall, vanish, occur, dissolve, appear
likes	die, exist, occur, fall, appear, suffer, attack, happen, react, move
mute	speak, mute, scream, shout, talk, stop, sound, hear, silence, respond
dress	dress, appear, change, look, wear, behave, act, fall, move, be
empty	empty, exist, overflow, fill, explode, disappear, die, grow, vanish, expand
roast	die, roast, burn, eat, starve, suffer, vomit, rise, perish, fire
never	exist, die, occur, happen, fail, appear, fall, change, suffer, succeed
pray	pray, die, cry, suffer, arise, sleep, happen, appear, cross, worship
HAVE	exist, die, happen, occur, appear, move, attack, suffer, react, change
stuff	hurt, explode, fall, object, happen, hit, move, harm, vomit, crash
KILL	die, kill, suffer, exist, perish, death, attack, live, murder, happen
harvest	harvest, die, produce, perish, fall, eat, exist, grow, suffer, consume
censor	censor, suffer, speak, object, exist, silence, act, defect, offend, harm
oversee	fail, intervene, interfere, occur, behave, succeed, suffer, act, exist, happen
denounce	suffer, die, exist, defect, perish, act, resign, offend, attack, change
just	exist, die, occur, object, happen, suffer, kill, disappear, change, fall
regulate	act, fail, exist, change, behave, suffer, regulate, interfere, intervene, occur
widen	die, exist, fall, suffer, occur, appear, move, happen, react, perish
through	die, fall, break, occur, happen, exist, move, fail, appear, disappear
combine	combine, occur, exist, merge, overlap, multiply, collide, appear, differ, change
nailed	die, exist, fall, appear, suffer, occur, move, happen, react, perish
git	die, git, jump, kill, attack, happen, move, disappear, do, exist
exceed	exceed, increase, fail, fall, occur, rise, gain, decrease, succeed, exist
battle	fight, die, lose, attack, win, fall, battle, flee, defeat, suffer
excuse	apologize, lie, suffer, appear, fail, complain, offend, exist, resign, speak
insult	insult, offend, retaliate, suffer, harm, respond, laugh, react, hurt, complain
spark	appear, happen, occur, react, spark, exist, act, ignite, move, explode
steer	steer, move, fail, do, behave, drive, lose, act, occur, err
OK	die, react, attack, stop, kill, exist, do, respond, harm, fight
conclude	conclude, occur, believe, die, exist, happen, appear, terminate, proceed, end
list	list, appear, exist, occur, disappear, change, join, vanish, happen, post
has	die, exist, occur, happen, fall, suffer, attack, kill, appear, disappear
crest	die, exist, fall, appear, suffer, occur, move, perish, attack, react
smooth	die, fall, exist, move, appear, suffer, occur, react, speak, object
me	me, exist, occur, suffer, happen, appear, be, die, behave, do
compute	compute, occur, exist, happen, calculate, do, change, computation, multiply, move
proof	die, exist, occur, appear, fall, suffer, happen, perish, attack, fail
color	change, color, appear, bleed, move, react, cry, yell, die, fade
missed	die, exist, fall, occur, appear, suffer, move, happen, react, perish
tattoo	bleed, die, tattoo, exist, bite, appear, hurt, kill, burn, harm
hike	hike, fall, jump, move, die, walk, do, run, kill, cross
ate	die, exist, fall, suffer, appear, occur, perish, move, attack, happen
green	die, exist, fall, suffer, appear, move, attack, perish, kill, react
diffuse	diffuse, disperse, move, occur, disappear, explode, dissolve, escalate, appear, react
mock	laugh, insult, ridicule, respond, offend, smile, react, mock, blush, retaliate
slide	slide, fall, slip, move, roll, jump, drop, tumble, stumble, collapse
Make	die, exist, appear, occur, fall, suffer, happen, move, perish, speak
stroke	stroke, fall, move, appear, scream, cry, faint, react, blush, bleed
monitor	watch, monitor, intervene, behave, suffer, act, fail, interfere, occur, disappear
brick	fall, hit, brick, attack, strike, hurt, die, retaliate, collapse, break
Tweet	tweet, respond, retweet, reply, react, post, comment, retaliate, twitter, click
blaze	die, fall, exist, perish, occur, suffer, appear, attack, explode, kill
ponder	think, occur, appear, exist, change, do, respond, arise, move, react
getting	die, exist, fall, happen, occur, kill, attack, suffer, harm, fail
stock	sell, fail, exist, occur, react, break, fire, suffer, die, kill
shit	shit, piss, vomit, poop, pee, fart, fuck, die, drink, happen
fuse	fuse, explode, collide, combust, react, occur, exist, multiply, merge, die
scan	scan, blink, move, die, jump, appear, attack, look, react, suffer
recycle	recycle, exist, change, die, waste, disappear, degrade, occur, refuse, reuse
piece	fall, bite, break, move, piece, cut, exist, eat, harm, disappear
modify	change, modify, exist, evolve, occur, appear, behave, suffer, act, die
water	drink, drown, boil, die, water, flood, thirst, vomit, pee, cry
locate	appear, exist, locate, vanish, disappear, occur, move, find, flee, arrive
peg	peg, jump, exist, move, disappear, fall, leap, appear, bite, lie
heed	obey, respond, speak, stop, react, act, occur, harm, do, behave
brown	burn, bleed, die, brown, eat, bite, fire, boil, cry, spit
retract	retract, change, disappear, withdraw, fall, leave, speak, disagree, respond, lie
over	fall, die, fail, lose, harm, suffer, move, occur, fight, cross
squeeze	squeeze, fall, move, object, choke, scream, stop, hurt, jump, cry
jam	jam, move, jump, fall, crash, explode, hit, break, slam, scream
obey	obey, comply, behave, act, suffer, do, stop, defect, change, follow
sip	drink, sip, swallow, vomit, drown, tap, spit, speak, fall, consume
muster	die, exist, appear, fall, occur, suffer, perish, move, attack, speak
gas	die, explode, jump, vomit, gas, kill, scream, bleed, react, combust
stay	leave, stay, go, die, change, disappear, move, return, remain, exist
stalk	stalk, disappear, exist, attack, flee, harm, harass, kill, move, behave
mash	mash, move, vomit, explode, collide, fall, hit, eat, drown, bite
adapt	change, adapt, evolve, do, adjust, differ, exist, occur, modify, act
deflect	deflect, react, respond, speak, flee, fail, move, occur, behave, object
despise	hate, despise, suffer, exist, die, dislike, rage, change, defect, despair
bind	bind, break, fall, move, suffer, die, hurt, escape, harm, appear
bit	bite, attack, die, hurt, bleed, scream, harm, strike, fall, jump
redesign	change, exist, evolve, redesign, appear, improve, occur, fail, disappear, die
reconsider	change, exist, react, die, occur, appear, respond, act, move, happen
slug	fall, retaliate, hit, scream, vomit, strike, bite, bleed, punch, hurt
bolt	bolt, fall, jump, break, snap, escape, fail, buckle, strike, move
rest	rest, die, suffer, fall, stop, collapse, occur, sleep, rise, work
poke	poke, laugh, move, hurt, scream, fall, smile, react, choke, bite
bullshit	lie, bullshit, fail, exist, laugh, cheat, mislead, deceive, talk, die
criticize	complain, retaliate, respond, suffer, offend, apologize, insult, attack, criticize, react
clarify	clarify, understand, change, misunderstand, explain, disagree, occur, answer, appear, speak
cash	cash, pay, die, happen, fall, exist, knock, cross, do, lose
round	fall, move, roll, jump, turn, stumble, hit, knock, strike, run
stamp	stamp, fall, bleed, appear, strip, sting, hurt, die, strike, write
knows	die, exist, kill, know, speak, harm, occur, do, react, appear
drag	fall, move, drag, stumble, disappear, appear, die, trip, jump, walk
fine	pay, complain, suffer, lose, sue, retaliate, fail, offend, act, object
throttle	die, choke, fall, fight, stop, retaliate, attack, vomit, flee, scream
lend	lend, borrow, give, help, assist, use, do, leave, pay, object
renew	renew, die, expire, exist, change, cease, return, retire, continue, occur
dump	dump, leave, die, exist, divorce, disappear, go, discard, move, marry
used	exist, die, occur, fall, appear, happen, move, attack, speak, suffer
plot	plot, happen, succeed, occur, exist, die, move, act, appear, behave
increase	increase, decrease, rise, grow, fall, decline, gain, change, reduce, diminish
link	link, exist, connect, occur, happen, communicate, appear, move, interact, cross
broadcast	broadcast, appear, transmit, communicate, defect, exist, speak, disappear, occur, change
sweep	sweep, fall, move, disappear, vomit, jump, appear, slip, vanish, leave
plead	die, fall, suffer, exist, speak, fail, occur, appear, intervene, complain
dish	vomit, eat, spit, dish, drink, bite, react, pay, respond, scream
weld	weld, break, fall, fail, move, jump, fracture, melt, bend, collapse
smear	slander, smear, lie, suffer, exist, harm, fall, lose, die, offend
betray	die, defect, betray, fail, lie, flee, act, cheat, suffer, kill
buckle	fall, buckle, hurt, move, break, object, suffer, happen, stumble, react
box	box, fall, fail, knock, fight, object, jump, stumble, hurt, move
praise	smile, laugh, complain, suffer, rejoice, respond, apologize, cheer, cry, praise
complicate	complicate, simplify, fail, confuse, change, differ, interfere, occur, appear, do
trace	disappear, appear, exist, vanish, trace, occur, move, die, happen, fall
sample	react, occur, eat, exist, jump, respond, bite, reproduce, behave, stop
transmit	transmit, communicate, exist, appear, manifest, occur, propagate, speak, reproduce, change
foresee	occur, happen, appear, exist, act, foresee, arise, intervene, believe, do
nickname	laugh, cry, exist, smile, appear, name, speak, respond, occur, shout
retain	change, leave, disappear, return, die, exist, perish, lose, go, remain
pee	pee, piss, poop, drink, go, fart, vomit, do, bleed, die
spawn	spawn, exist, occur, appear, arise, die, evolve, happen, reproduce, emerge
temper	temper, react, rage, shout, speak, suffer, yell, behave, disagree, change
analyse	react, think, analyse, suffer, change, behave, respond, act, exist, occur
threaten	flee, harm, die, attack, kill, retaliate, suffer, act, panic, respond
skate	skate, fall, move, jump, crash, walk, speed, dance, ski, die
pardon	suffer, die, pardon, live, resign, apologize, repent, benefit, appear, exist
reboot	reboot, crash, die, malfunction, restart, run, fail, jump, reset, exist
tax	tax, suffer, pay, benefit, fail, act, lose, exist, die, increase
dedicate	die, exist, do, occur, happen, fail, love, hate, suffer, live
discharge	discharge, die, leave, suffer, occur, fail, harm, injure, strike, fight
okay	harm, attack, die, react, exist, kill, occur, happen, hurt, respond
dim	dim, die, move, scream, drown, faint, appear, speak, attack, glow
connect	connect, exist, communicate, interact, occur, appear, move, bond, happen, react
FIX	die, exist, fall, appear, suffer, occur, move, react, speak, happen
dry	dry, wet, rise, do, drink, die, bleed, pee, cry, drip
ration	die, exist, suffer, fail, eat, perish, defect, react, occur, change
darn	die, exist, suffer, fall, appear, occur, perish, happen, move, attack
at	fall, attack, harm, move, react, scream, strike, shout, laugh, object
weaken	weaken, suffer, fall, die, fail, break, decline, change, collapse, diminish
remedy	suffer, occur, exist, die, appear, change, happen, improve, succeed, fail
divert	divert, fail, occur, intervene, flee, act, react, move, distract, appear
bat	bat, hit, fly, swing, bite, strike, fall, pitch, run, do
complement	succeed, improve, benefit, excel, exist, grow, change, differ, flourish, increase
alter	change, appear, exist, occur, alter, die, suffer, act, behave, react
polish	polish, shine, improve, fail, fall, work, change, do, move, paint
deem	exist, change, die, appear, be, occur, suffer, think, cease, kill
contest	lose, win, succeed, fall, fail, exist, fight, prevail, die, occur
dub	exist, dub, slur, speak, appear, change, offend, laugh, identify, occur
game	die, play, lose, move, cheat, attack, fail, fall, succeed, jump
torpedo	torpedo, die, drown, perish, attack, fail, exist, fall, sink, lose
pot	boil, vomit, drink, die, fall, burn, kill, fire, smoke, pot
blend	blend, differ, appear, overlap, occur, mix, change, exist, separate, merge
tough	die, fall, suffer, exist, appear, react, attack, move, kill, flee
pound	fall, suffer, vomit, strike, faint, hurt, choke, pound, stumble, bite
silence	speak, silence, scream, shout, die, talk, suffer, exist, disappear, listen
piss	piss, pee, spit, drink, vomit, fart, complain, cry, laugh, explode
conceal	hide, lie, disappear, appear, deceive, conceal, exist, occur, escape, vanish
spray	spray, explode, vomit, scream, shoot, drown, bleed, fire, drink, die
yield	yield, exist, occur, produce, happen, arise, succeed, die, fail, do
if	exist, die, occur, happen, be, appear, fail, fall, suffer, kill
bark	bark, shout, scream, yell, jump, bite, cry, stop, laugh, attack
sit	sit, move, fall, stand, rise, leave, appear, eat, stop, go
defy	fail, defect, die, suffer, act, exist, object, comply, rebel, obey
wheel	move, die, fall, do, turn, drive, wheel, object, spin, crash
microwave	die, react, vomit, fall, explode, jump, attack, scream, move, eat
earned	die, exist, fall, suffer, appear, occur, perish, happen, move, react
exhibit	exhibit, appear, act, behave, occur, exist, react, display, show, change
commemorate	exist, die, rejoice, occur, celebrate, appear, live, mourn, smile, suffer
flood	flood, drown, overflow, sink, rise, fail, die, flee, explode, escape
panic	panic, react, flee, jump, worry, fear, scream, alarm, die, cry
plate	die, fall, exist, suffer, appear, occur, move, react, attack, perish
chose	choose, exist, change, die, win, occur, appear, succeed, chose, lose
dwarf	fall, die, fail, exist, stumble, appear, move, faint, grow, lose
communicate	communicate, speak, respond, exist, talk, understand, appear, reply, occur, hear
befriend	befriend, exist, appear, cooperate, behave, benefit, interact, meet, succeed, smile
trump	win, lose, prevail, succeed, triumph, dominate, fail, rise, gain, exist
tire	tire, suffer, sweat, faint, die, complain, fall, wear, hurt, fatigue
forfeit	forfeit, lose, die, win, suffer, fail, perish, gain, pay, disappear
combat	fight, die, attack, suffer, lose, fail, harm, flee, fall, perish
STOP	stop, die, react, intervene, act, respond, occur, happen, move, suffer
abort	die, abort, perish, suffer, terminate, fail, conceive, defect, survive, death
date	date, marry, exist, propose, kiss, cheat, die, leave, love, object
Try	die, exist, fall, suffer, appear, occur, move, attack, perish, react
stage	appear, occur, act, happen, fail, perform, react, exist, move, die
title	exist, appear, occur, name, title, speak, object, change, be, differ
frost	die, fall, exist, appear, suffer, attack, react, move, kill, occur
nurse	die, nurse, vomit, suffer, bleed, cry, sleep, eat, faint, wake
examine	examine, act, react, question, appear, look, observe, investigate, object, respond
integrate	integrate, exist, merge, change, occur, interact, join, appear, separate, divide
tease	laugh, smile, blush, react, respond, tease, object, retaliate, behave, chuckle
stream	disappear, stream, drown, exist, die, jump, speak, occur, appear, communicate
signal	signal, respond, react, appear, communicate, speak, act, move, sign, notice
label	exist, label, change, suffer, appear, name, object, offend, harm, occur
crumble	crumble, collapse, fall, break, topple, fracture, shatter, crack, fail, dissolve
bum	fall, hit, harm, die, jump, knock, hurt, crash, vomit, happen
trim	trim, cut, grow, fall, move, shrink, disappear, bleed, jump, appear
pinpoint	exist, identify, occur, appear, move, notice, disappear, object, happen, react
channel	speak, appear, exist, channel, communicate, act, manifest, transform, react, change
pawn	pawn, sell, steal, disappear, exist, vanish, lose, pay, buy, die
ignite	ignite, combust, explode, burn, fire, die, appear, react, occur, escape
blew	die, exist, fall, appear, suffer, occur, move, react, speak, perish
boot	leave, boot, quit, go, resign, lose, fail, flee, fall, move
pirate	pirate, steal, exist, defect, attack, race, do, cheat, happen, disappear
pave	die, exist, fall, appear, suffer, occur, move, happen, perish, speak
bully	bully, retaliate, fight, lose, suffer, harm, attack, respond, object, behave
accelerate	accelerate, react, stop, move, occur, speed, crash, jump, die, happen
overthrow	overthrow, fall, fail, rise, succeed, die, rule, collapse, exist, revolt
value	value, exist, suffer, benefit, object, pay, live, care, appreciate, change
weave	weave, fall, break, exist, move, occur, do, turn, fold, happen
envision	appear, exist, occur, happen, think, arise, imagine, dream, see, believe
claw	bite, claw, scratch, attack, fall, strike, die, hurt, fight, scream
contemplate	think, contemplate, exist, occur, appear, act, react, object, change, respond
register	register, exist, appear, occur, die, change, join, move, pass, sign
slaughter	die, kill, perish, suffer, murder, death, exist, live, slaughter, flee
whistle	whistle, shout, laugh, yell, stop, complain, scream, speak, cry, sing
market	sell, exist, market, succeed, profit, buy, appear, advertise, reproduce, purchase
cave	die, exist, fall, occur, appear, suffer, attack, happen, move, perish
ready	die, exist, fall, occur, appear, suffer, happen, move, react, perish
distribute	distribute, exist, disperse, perish, circulate, produce, die, occur, fail, sell
extend	extend, exist, grow, end, cease, change, increase, occur, disappear, stop
treat	suffer, behave, die, harm, act, hurt, react, respond, exist, change
nod	nod, move, react, respond, laugh, smile, turn, speak, jerk, blink
hoard	hoard, starve, accumulate, consume, steal, die, disappear, sell, lose, flee
brake	brake, stop, accelerate, crash, fall, react, drive, move, fail, jump
stumble	stumble, fall, stagger, move, happen, occur, die, run, cross, walk
disappoint	fail, suffer, disappoint, complain, die, upset, worry, lose, react, decline
fixed	die, exist, appear, occur, fall, happen, suffer, move, react, speak
spur	react, move, act, occur, happen, appear, speak, stop, jump, run
next	die, exist, fall, occur, suffer, appear, move, attack, happen, perish
upset	upset, suffer, react, harm, act, behave, occur, complain, hurt, change
bleach	bleach, die, vomit, drown, bleed, boil, drink, explode, change, suffer
vote	vote, win, lose, die, succeed, pass, defect, run, change, exist
emulate	succeed, exist, improve, evolve, change, behave, appear, act, do, differ
bash	retaliate, lose, attack, suffer, harm, laugh, insult, hurt, offend, fail
dent	fall, die, hurt, bleed, bite, suffer, harm, move, break, injure
prosecute	die, suffer, flee, prosecute, sue, fail, act, lose, retaliate, resign
champion	succeed, win, triumph, exist, prevail, lose, fail, suffer, die, fight
stunt	fall, jump, react, move, hurt, crash, fail, stumble, injure, stunt
contact	contact, exist, communicate, respond, call, appear, occur, react, act, speak
breed	breed, reproduce, exist, die, evolve, grow, occur, appear, develop, change
death	die, death, perish, exist, live, kill, suffer, occur, dies, life
mastermind	die, exist, fall, suffer, occur, appear, happen, perish, attack, kill
scoop	fall, scoop, jump, drop, eat, flee, move, vomit, swallow, bite
breach	breach, break, fall, harm, enter, escape, attack, flee, occur, hurt
gather	gather, disperse, fall, assemble, appear, flee, fight, attack, move, rise
wax	exist, die, change, wax, appear, move, speak, grow, bleed, stop
eclipse	appear, disappear, vanish, exist, eclipse, fail, occur, dominate, lose, fade
brush	brush, fall, move, trip, blush, scratch, jump, appear, touch, slip
steel	die, fall, suffer, exist, appear, move, react, attack, occur, perish
observe	observe, appear, react, act, notice, watch, look, see, stare, object
liked	die, exist, appear, occur, fall, suffer, react, move, change, attack
sting	sting, hurt, bite, bleed, scream, die, suffer, cry, fall, harm
broke	die, exist, fall, appear, suffer, occur, move, happen, perish, speak
dispatch	die, dispatch, fight, flee, perish, escape, kill, disappear, fall, exist
beam	beam, jump, react, move, laugh, appear, die, exist, attack, cross
wanted	die, exist, occur, fall, appear, suffer, happen, move, perish, react
Get	die, exist, fall, suffer, occur, appear, happen, move, perish, attack
accompany	appear, move, fall, occur, exist, follow, walk, leave, disappear, die
revisit	return, change, exist, die, appear, occur, disappear, react, happen, move
utilize	use, benefit, utilize, exist, occur, consume, do, perform, work, function
encrypt	encrypt, decrypt, communicate, exist, disappear, intercept, break, attack, fail, interfere
divine	exist, die, appear, arise, divine, evolve, change, occur, do, happen
fade	die, exist, appear, fall, move, disappear, suffer, occur, attack, react
punish	suffer, die, retaliate, act, fail, harm, behave, lose, kill, offend
decline	decline, refuse, object, reject, fail, accept, leave, respond, withdraw, offer
glass	die, fall, exist, suffer, appear, move, occur, perish, react, attack
smile	smile, laugh, frown, grin, blush, cry, yawn, appear, chuckle, cheer
operate	operate, function, fail, malfunction, work, occur, exist, act, run, do
separate	separate, split, exist, die, divide, disappear, occur, suffer, differ, move
concoct	exist, die, occur, appear, happen, change, perish, kill, fail, fall
damage	die, harm, suffer, fall, hurt, damage, injure, break, fail, injury
dab	die, fall, exist, appear, move, react, suffer, speak, occur, attack
cloud	appear, cloud, disappear, drown, fall, vanish, fly, rise, fail, move
access	access, exist, appear, enter, login, die, disappear, occur, leave, communicate
patrol	die, exist, kill, attack, occur, move, appear, harm, fall, intervene
thwart	fail, succeed, die, perish, occur, act, intervene, fall, suffer, happen
recount	occur, speak, appear, exist, die, happen, change, disappear, differ, respond
navigate	navigate, move, cross, communicate, turn, walk, interact, intervene, travel, fail
price	die, suffer, exist, fall, sell, pay, fail, lose, harm, succeed
hole	die, fall, exist, appear, move, occur, suffer, attack, kill, disappear
model	appear, model, behave, change, exist, evolve, reproduce, regress, react, grow
prescribe	prescribe, exist, die, suffer, change, occur, fail, appear, act, intervene
scalp	bite, fall, die, attack, fight, suffer, bleed, strike, hit, occur
pair	pair, mate, occur, appear, exist, bond, match, interact, separate, cross
maybe	die, exist, happen, object, do, think, occur, react, hurt, respond
surface	surface, appear, exist, emerge, disappear, occur, arise, rise, vanish, happen
affect	suffer, change, react, act, occur, exist, die, appear, happen, behave
strip	strip, object, leave, disappear, suffer, move, appear, scream, resist, flee
free	die, live, free, escape, suffer, exist, release, fall, return, flee
derive	exist, occur, arise, derive, evolve, die, change, disappear, happen, perish
latch	latch, move, fall, defect, bite, jump, object, escape, exist, do
imitate	appear, exist, behave, act, imitate, laugh, change, differ, succeed, do
sand	sand, fall, move, hit, break, hurt, burn, strike, destroy, sink
doom	die, perish, doom, suffer, fall, fail, succeed, exist, death, despair
deed	die, do, act, kill, exist, happen, occur, react, harm, object
egg	egg, die, laugh, jump, cry, bite, do, flee, reproduce, occur
showcase	appear, exist, occur, react, change, object, speak, disappear, defect, happen
harness	suffer, escape, move, attack, exist, fall, fight, fail, harness, react
Do	do, die, happen, occur, exist, act, fail, object, behave, change
bad	suffer, die, harm, bad, do, evil, hurt, behave, happen, exist
killed	die, kill, exist, perish, death, suffer, live, fall, happen, murder
illustrate	appear, exist, occur, move, happen, object, speak, change, react, behave
filter	filter, speak, discriminate, appear, change, fail, behave, distort, exist, hear
step	fall, step, move, jump, walk, stumble, die, leap, run, cross
kid	laugh, cry, behave, hurt, smile, fall, lie, suffer, react, act
urge	act, intervene, behave, object, move, respond, do, react, think, speak
violate	violate, transgress, harm, offend, suffer, act, break, exist, object, occur
lease	rent, lease, exist, leave, sell, pay, move, defect, die, object
is	exist, be, occur, die, appear, happen, kill, change, fall, move
key	die, move, attack, jump, kill, speak, do, fall, exist, escape
nurture	grow, thrive, flourish, succeed, reproduce, develop, exist, nurture, prosper, behave
sever	die, break, fall, suffer, fracture, sever, disappear, collapse, perish, hurt
enact	act, happen, occur, exist, appear, do, change, die, enact, react
intend	exist, occur, happen, act, do, intend, die, appear, succeed, kill
ingest	ingest, die, eat, consume, vomit, exist, drink, swallow, fall, overdose
blur	die, fall, exist, appear, move, occur, suffer, react, speak, object
prick	bite, move, bleed, hurt, jump, react, scream, fall, itch, twitch
reform	change, reform, suffer, improve, succeed, fail, defect, behave, exist, die
bookmark	exist, do, appear, happen, die, move, disappear, occur, behave, attack
can	die, exist, appear, attack, suffer, fall, move, speak, kill, fail
spare	die, suffer, live, perish, benefit, survive, death, harm, fall, pay
haul	fall, haul, move, harm, object, hit, fight, stumble, leave, do
hurdle	fall, jump, stumble, fail, leap, break, cross, overcome, move, crash
quite	die, fall, exist, occur, appear, speak, object, fail, laugh, suffer
realized	die, exist, appear, occur, fall, suffer, move, happen, speak, react
essay	die, exist, fall, appear, occur, suffer, speak, attack, object, perish
shop	shop, buy, sell, pay, exist, purchase, trade, do, behave, steal
populate	exist, occur, multiply, die, arise, appear, disappear, evolve, change, move
dust	dust, fly, fall, tire, behave, appear, move, trip, do, scratch
invest	invest, exist, fail, fall, lose, succeed, suffer, die, occur, increase
highlight	appear, react, occur, object, exist, disappear, notice, move, shout, change
grit	die, exist, fall, suffer, appear, move, occur, react, perish, attack
terminate	die, terminate, perish, exist, expire, suffer, leave, end, occur, kill
script	write, speak, happen, exist, appear, act, behave, occur, react, die
seen	see, appear, move, exist, react, look, occur, happen, disappear, turn
gasp	die, exist, fall, appear, suffer, occur, move, react, perish, speak
perpetuate	exist, occur, perpetuate, die, continue, evolve, change, reproduce, arise, happen
update	update, change, improve, evolve, upgrade, exist, appear, fail, modify, regress
but	fall, move, leave, fail, break, exist, change, object, die, disappear
delay	delay, fail, wait, occur, stop, suffer, react, die, act, intervene
travel	exist, travel, move, die, occur, change, disappear, go, leave, happen
mess	mess, happen, interfere, explode, fall, stumble, behave, do, object, occur
dance	dance, move, fall, perform, do, stop, sing, act, sway, laugh
dictate	change, dictate, exist, act, rule, behave, occur, happen, decide, appear
spew	spew, spit, vomit, explode, speak, erupt, shout, fire, scream, exist
manifest	manifest, appear, exist, occur, happen, arise, disappear, vanish, emerge, act
relay	relay, communicate, speak, respond, occur, transmit, react, talk, appear, hear
negotiate	negotiate, leave, change, pay, lose, move, disagree, fall, win, contract
dam	drown, die, drink, fall, harm, kill, flood, sink, scream, suffer
pedal	die, fall, move, exist, occur, fail, suffer, stop, appear, speak
dissolve	dissolve, disappear, vanish, exist, explode, collapse, break, appear, die, occur
withdraw	withdraw, leave, disappear, withdrawal, vanish, flee, exit, go, move, depart
limit	limit, fail, suffer, stop, shrink, grow, increase, change, exist, reduce
seed	seed, exist, die, breed, reproduce, occur, grow, sow, conceive, arise
foster	foster, exist, succeed, reproduce, die, suffer, develop, fail, thrive, occur
scare	panic, flee, fear, scream, die, react, jump, attack, appear, worry
lie	lie, deceive, mislead, cheat, exist, do, believe, fall, die, speak
advocate	succeed, exist, suffer, prevail, benefit, win, act, believe, die, disagree
pretend	appear, exist, pretend, lie, act, die, disappear, happen, deceive, occur
prize	die, exist, suffer, succeed, fail, fall, perish, win, lose, occur
chain	break, chain, escape, snap, jump, move, bind, fall, disappear, suffer
reference	exist, occur, appear, reference, speak, quote, comment, object, change, respond
clip	fall, bite, jump, clip, stop, die, scream, choke, drop, bleed
wait	wait, delay, die, stop, leave, arrive, pause, suffer, move, do
cough	cough, vomit, choke, breathe, smoke, cry, spit, laugh, scream, coughing
parse	parse, interpret, understand, speak, read, move, change, fail, disagree, translate
formulate	exist, occur, change, appear, arise, formulate, happen, develop, differ, evolve
provoke	react, act, provoke, respond, attack, retaliate, laugh, occur, suffer, panic
buck	fall, buck, move, buckle, jump, crash, do, object, laugh, happen
copyright	exist, reproduce, copy, defect, change, succeed, appear, die, object, steal
occupy	exist, move, appear, disappear, occupy, occur, suffer, vanish, arise, sleep
attend	attend, occur, appear, exist, arrive, go, happen, act, leave, behave
finger	move, snap, scream, bite, slap, react, object, strike, finger, respond
wake	wake, awaken, sleep, rise, awake, move, stir, appear, die, arise
tank	die, attack, fall, fail, defect, react, exist, jump, suffer, kill
place	place, move, occur, fall, exist, appear, happen, be, go, disappear
suppress	disappear, suffer, exist, suppress, change, occur, die, fail, appear, cease
freak	freak, panic, react, scream, jump, worry, fear, act, cry, suffer
loved	die, exist, suffer, kill, hate, love, live, fall, leave, harm
headline	exist, die, occur, fall, appear, happen, suffer, speak, succeed, attack
facilitate	occur, happen, succeed, benefit, do, facilitate, exist, act, proceed, suffer
field	exist, occur, die, appear, attack, fall, happen, fail, respond, do
draft	draft, fail, defect, resign, fight, die, lose, change, exist, succeed
ram	fall, die, hit, move, jump, crash, object, attack, occur, react
establish	exist, occur, appear, establish, change, arise, happen, die, emerge, succeed
amend	change, exist, occur, differ, amend, appear, act, object, happen, fail
eye	stare, blink, look, glare, object, smile, speak, move, react, laugh
strain	strain, fall, hurt, move, suffer, collapse, break, weaken, fail, buckle
circle	move, strike, react, die, appear, disappear, circle, fall, jump, collide
bed	sleep, die, bed, marry, fall, leave, kiss, do, lie, exist
resemble	appear, exist, resemble, differ, change, occur, behave, move, evolve, be
tape	jump, tape, scream, record, die, speak, talk, bite, move, stop
KNOW	know, exist, be, understand, speak, respond, appear, do, talk, think
procure	exist, procure, produce, appear, die, sell, acquire, obtain, kill, buy
compare	differ, disagree, improve, compare, exist, fall, suffer, succeed, complain, change
rival	win, succeed, lose, dominate, prevail, exist, differ, fail, improve, triumph
skirt	skirt, cross, move, pass, dance, jump, walk, interfere, fall, appear
harm	harm, die, suffer, kill, fall, exist, hurt, perish, death, attack
undermine	fall, fail, suffer, succeed, decline, harm, lose, die, weaken, collapse
void	void, exist, fail, die, disappear, cancel, vanish, occur, null, fall
favor	win, benefit, suffer, lose, succeed, gain, prevail, favor, advantage, prosper
project	appear, project, exist, change, occur, regress, manifest, happen, disappear, defect
butter	eat, die, boil, scream, bite, hurt, cry, melt, fall, happen
cream	die, exist, appear, fall, speak, laugh, suffer, react, defect, change
crawl	crawl, die, move, fall, bite, jump, walk, eat, vomit, bleed
tried	die, exist, fall, appear, occur, suffer, happen, move, react, perish
Like	die, exist, fall, appear, suffer, occur, move, react, happen, attack
revoke	revoke, fail, leave, change, expire, lose, decline, cease, die, exist
advise	intervene, advise, succeed, think, act, believe, speak, respond, suffer, fail
revise	change, differ, exist, disagree, occur, fail, improve, revise, evolve, appear
jail	jail, die, suffer, flee, escape, arrest, appear, disappear, riot, prison
captain	die, exist, fall, suffer, occur, appear, perish, fail, happen, attack
ridicule	ridicule, laugh, suffer, offend, insult, respond, exist, smile, react, speak
quote	quote, disagree, laugh, comment, reply, speak, respond, appear, exist, lie
target	retaliate, attack, harm, die, kill, act, occur, react, flee, respond
finished	die, exist, fall, suffer, appear, occur, perish, happen, move, react
flag	flag, fail, fire, stop, fall, cheat, jump, signal, defect, lie
matter	matter, exist, die, occur, care, change, happen, suffer, appear, complain
merge	merge, overlap, collide, exist, change, converge, combine, evolve, join, disappear
expend	die, exist, fall, appear, suffer, occur, perish, move, attack, kill
devise	exist, occur, change, die, appear, happen, fail, arise, do, succeed
ramp	die, exist, fall, appear, suffer, move, occur, react, attack, speak
big	fall, die, grow, hurt, hit, explode, move, object, break, attack
flick	move, fall, flick, blink, flip, jump, react, scream, laugh, turn
critique	complain, disagree, respond, criticize, suffer, fail, change, comment, react, offend
shade	blush, harm, shade, glare, appear, rage, smile, react, suffer, hurt
rig	fail, cheat, rig, fall, defect, lie, win, suffer, object, interfere
sock	sock, pay, retaliate, lose, object, complain, sue, steal, suffer, hurt
code	code, function, exist, change, behave, work, write, occur, crash, fail
mug	mug, bite, fall, retaliate, attack, fight, scream, die, drink, hit
overpower	fall, die, flee, attack, faint, fight, suffer, resist, dominate, disappear
off	die, jump, attack, flee, move, fall, react, bite, leave, harm
amplify	amplify, speak, sound, occur, increase, change, exist, grow, appear, multiply
half	die, fall, exist, cross, suffer, harm, kill, disappear, fail, stop
stake	fall, strike, die, stake, cross, move, attack, harm, jump, kill
profess	exist, speak, appear, change, die, believe, lie, occur, defect, cease
condone	act, exist, suffer, behave, offend, die, occur, intervene, benefit, harm
worship	worship, die, suffer, exist, sin, kill, hate, pray, live, believe
view	view, see, look, appear, react, object, exist, act, think, speak
near	move, fall, jump, harm, appear, object, react, touch, attack, faint
punt	move, fall, punt, hit, defect, die, leave, occur, disappear, exist
abolish	exist, disappear, perish, vanish, die, change, cease, abolish, appear, occur
credit	credit, pay, benefit, exist, succeed, win, occur, complain, die, appear
video	die, scream, react, jump, intervene, speak, respond, appear, exist, laugh
stress	stress, panic, react, suffer, worry, cry, hurt, complain, distress, upset
influence	change, act, behave, think, appear, react, happen, occur, speak, influence
streak	die, exist, fall, suffer, appear, occur, move, attack, react, perish
postpone	delay, postpone, occur, die, happen, appear, fail, suffer, wait, exist
probably	die, exist, occur, happen, kill, do, appear, object, fail, speak
fingerprint	bite, die, appear, move, disappear, jump, exist, panic, attack, object
scout	scout, fail, move, spy, exist, act, lose, kill, lie, leave
invented	die, exist, occur, appear, fall, happen, suffer, perish, move, live
WIN	die, exist, appear, fall, suffer, occur, move, react, happen, speak
disappear	disappear, vanish, appear, exist, occur, die, happen, leave, go, return
stomp	fall, stomp, die, kick, strike, hurt, stumble, move, harm, bleed
out	die, fall, exist, leave, escape, attack, fight, kill, lose, harm
tag	tag, respond, disappear, retaliate, react, appear, post, comment, exist, tweet
reconstruct	exist, appear, change, disappear, occur, evolve, die, vanish, transform, happen
recharge	die, exist, fall, appear, suffer, move, occur, react, speak, attack
wrestle	fall, wrestle, lose, submit, fight, win, stumble, choke, grapple, interfere
extract	disappear, escape, extract, leave, vanish, exist, withdraw, fall, suffer, flee
butt	hit, fall, butt, hurt, kick, punch, strike, stumble, smack, object
contradict	disagree, lie, differ, contradict, exist, change, fail, object, speak, appear
envy	envy, suffer, jealousy, complain, gain, smile, laugh, fear, hate, jealous
deepen	die, exist, appear, fall, suffer, occur, move, speak, react, happen
exit	exit, leave, enter, escape, depart, flee, return, disappear, die, go
shot	die, shoot, kill, fire, fall, shot, explode, death, flee, act
flank	move, fall, jump, flee, cross, attack, pass, stumble, retreat, leap
discount	suffer, discount, complain, lose, decline, fail, diminish, fall, die, cheat
rob	rob, die, steal, flee, disappear, harm, kill, murder, intervene, fall
spy	spy, appear, exist, watch, observe, act, disappear, lie, know, interfere
remix	change, remix, exist, reproduce, modify, evolve, differ, do, occur, dance
mimic	appear, exist, behave, laugh, act, react, occur, speak, change, imitate
reproduce	reproduce, exist, die, occur, appear, evolve, produce, multiply, live, develop
root	root, die, exist, rise, fail, grow, do, move, occur, win
pilot	die, exist, fail, occur, fall, crash, move, happen, attack, kill
discard	discard, leave, die, depart, go, disappear, return, object, exist, change
package	exist, occur, change, disappear, appear, defect, move, behave, fail, happen
you	you, exist, die, suffer, harm, do, be, happen, occur, act
deal	deal, die, pay, suffer, harm, exist, do, give, happen, occur
shell	shell, explode, die, disappear, fail, crash, attack, fall, suffer, occur
satisfy	exist, satisfy, suffer, occur, live, succeed, act, happen, die, appear
source	exist, produce, source, originate, occur, obtain, create, reproduce, supply, steal
raid	flee, attack, raid, steal, disappear, intervene, leave, go, fail, escape
hitch	die, fall, move, exist, appear, occur, suffer, speak, fail, attack
hem	die, exist, fall, appear, suffer, occur, move, react, speak, attack
scarf	die, bite, fall, hurt, react, scream, jump, harm, attack, flee
dial	dial, call, answer, ring, respond, speak, talk, phone, die, disconnect
discredit	suffer, die, fail, perish, harm, lose, succeed, fall, exist, disappear
compost	compost, eat, exist, die, do, occur, disappear, produce, happen, poop
that	exist, die, occur, suffer, happen, appear, object, fall, be, react
bloom	die, exist, fall, appear, suffer, occur, perish, move, react, happen
so	die, exist, occur, happen, do, speak, respond, react, move, appear
Read	die, exist, fall, occur, appear, suffer, move, speak, attack, happen
shun	shun, leave, behave, act, suffer, object, retaliate, offend, harm, hate
frog	die, exist, fall, appear, occur, attack, suffer, speak, move, disappear
chill	chill, scream, panic, jump, cry, react, freeze, move, shout, stop
hawk	exist, die, kill, attack, defect, harm, fight, fall, lose, cross
shock	react, panic, scream, shock, jump, recoil, shudder, laugh, respond, move
triple	die, exist, fall, occur, suffer, appear, move, fail, disappear, perish
soak	drown, drink, sink, boil, vomit, sweat, swim, rise, splash, soak
reward	succeed, suffer, win, benefit, die, pay, behave, work, fail, rise
moderate	change, disagree, react, suffer, behave, moderate, differ, fail, act, respond
corrupt	corrupt, fail, die, suffer, cheat, defect, benefit, disappear, harm, corruption
isolate	isolate, suffer, disappear, leave, exist, die, harm, separate, change, fail
worry	worry, panic, fear, suffer, react, think, distress, fret, act, harm
numb	die, numb, suffer, scream, hurt, react, move, cry, bleed, feel
kind	hurt, die, exist, happen, do, suffer, act, cry, behave, harm
up	fall, die, jump, rise, move, fight, speak, do, happen, suffer
foul	foul, fall, harm, die, suffer, fight, hurt, vomit, drink, attack
though	exist, die, occur, appear, fall, attack, happen, change, move, speak
ground	fall, break, die, move, fail, stumble, collapse, ground, jump, land
confuse	confuse, misunderstand, panic, react, speak, occur, think, appear, confusion, object
sober	die, drink, fall, vomit, exist, appear, speak, suffer, kill, occur
cracked	die, exist, fall, suffer, appear, occur, move, happen, perish, speak
mortgage	die, exist, fall, suffer, perish, occur, appear, happen, move, live
blunt	speak, fall, object, react, move, die, stumble, explode, harm, hit
pencil	die, exist, move, fall, bleed, jump, do, happen, cross, object
gust	die, exist, fall, appear, suffer, occur, move, react, speak, attack
outweigh	exist, die, fall, lose, suffer, win, dominate, succeed, occur, prevail
crunch	die, fall, exist, suffer, move, appear, react, attack, occur, explode
inhabit	exist, inhabit, appear, live, arise, occur, move, die, form, reside
wit	die, exist, wit, occur, fight, speak, attack, lose, do, perish
mask	appear, hide, disappear, exist, deceive, lie, speak, defect, occur, flee
anchor	anchor, break, fall, move, jump, weaken, bind, collapse, exist, bond
jog	jog, run, move, walk, jump, stumble, fall, stop, race, react
shrug	die, fall, exist, appear, suffer, react, move, occur, speak, attack
aid	benefit, suffer, succeed, help, aid, assist, live, die, intervene, survive
by	harm, die, occur, kill, exist, attack, fall, happen, appear, act
divorce	divorce, marry, die, leave, separate, split, fail, suffer, defect, live
mistake	mistake, misunderstand, deceive, fall, fail, stumble, mislead, lie, err, occur
transport	move, die, fall, travel, appear, exist, escape, trip, suffer, leave
debut	die, exist, occur, appear, fall, suffer, happen, move, speak, react
illuminate	appear, glow, see, illuminate, move, shine, exist, light, transform, disappear
to	die, harm, exist, suffer, occur, happen, fall, kill, object, react
fool	deceive, lie, fail, fall, cheat, fool, believe, laugh, succeed, think
capitalize	exist, occur, appear, speak, happen, capitalize, succeed, change, rise, differ
hum	hum, scream, speak, respond, laugh, shout, stop, talk, react, sing
solder	solder, fail, do, malfunction, melt, jump, break, react, move, run
counterfeit	exist, defect, change, die, counterfeit, appear, disappear, vanish, jump, perish
BE	exist, be, appear, die, change, occur, disappear, happen, return, transform
resume	die, exist, occur, appear, fall, happen, suffer, fail, speak, attack
care	care, die, worry, exist, suffer, act, feel, behave, hurt, live
torture	suffer, die, torture, kill, defect, death, escape, flee, disappear, fall
breakdown	break, die, exist, fall, change, disappear, defect, fail, collapse, dissolve
swarm	swarm, attack, flee, panic, bite, move, jump, die, appear, leave
overtake	overtake, lose, pass, win, succeed, fall, prevail, advance, fail, occur
perceive	perceive, appear, exist, see, act, think, react, object, speak, look
pepper	bite, react, jump, attack, scream, respond, move, laugh, object, retaliate
boost	rise, succeed, increase, benefit, improve, grow, gain, win, suffer, thrive
state	state, exist, occur, say, speak, lie, appear, change, happen, disagree
brand	exist, sell, brand, change, appear, object, mislead, defect, offend, succeed
too	die, exist, fall, suffer, harm, appear, occur, speak, move, react
construct	exist, construct, appear, occur, form, fail, create, arise, function, build
blown	die, exist, fall, appear, suffer, occur, move, react, perish, happen
cycle	cycle, reproduce, die, exist, react, occur, do, change, happen, spin
shotgun	shoot, die, kill, flee, attack, explode, fire, fight, shotgun, jump
coordinate	coordinate, occur, change, move, happen, react, exist, behave, do, interfere
pen	write, exist, pen, die, speak, occur, happen, communicate, appear, read
upgrade	upgrade, improve, change, evolve, benefit, succeed, work, increase, exist, better
debug	debug, crash, break, fail, run, code, occur, work, regress, malfunction
steam	steam, explode, orgasm, boil, sweat, drown, burn, scream, combust, cum
such	exist, die, occur, suffer, perish, harm, object, appear, be, do
cherry	die, exist, fall, suffer, appear, occur, perish, move, attack, react
bail	bail, die, fall, flee, jump, fail, suffer, intervene, leave, escape
from	exist, occur, die, fall, happen, harm, fail, disappear, appear, object
called	die, exist, appear, occur, fall, move, suffer, speak, happen, react
march	move, fall, die, fight, attack, occur, appear, strike, react, run
cite	cite, quote, write, disagree, reply, exist, speak, respond, comment, appear
transform	change, transform, appear, evolve, exist, disappear, die, occur, shift, manifest
venture	die, exist, fall, appear, occur, suffer, perish, happen, move, attack
fare	die, exist, fall, suffer, appear, occur, perish, move, attack, kill
swat	bite, scream, fall, move, strike, retaliate, object, hit, react, swat
attract	appear, exist, attract, act, leave, change, occur, respond, behave, move
arm	die, fall, fight, shoot, disarm, harm, suffer, attack, kill, fire
expel	leave, expel, flee, die, escape, depart, disappear, defect, return, exit
cops	die, exist, fall, suffer, occur, appear, happen, perish, attack, kill
enhance	improve, benefit, enhance, appear, increase, grow, change, succeed, exist, excel
thread	fall, do, object, thread, happen, die, occur, move, cross, jump
counteract	occur, succeed, fail, exist, change, prevail, happen, suffer, appear, win
uphold	exist, fall, fail, harm, prevail, break, die, occur, succeed, object
and	occur, exist, die, happen, be, do, fall, fail, appear, suffer
charter	exist, defect, die, occur, succeed, fail, perish, kill, disappear, arise
adjust	adjust, change, react, act, move, do, occur, alter, fail, compensate
wants	die, exist, occur, fall, appear, happen, suffer, attack, move, perish
point	point, move, object, react, look, stop, shout, turn, speak, respond
waterproof	die, exist, fall, appear, suffer, occur, move, perish, react, speak
stole	steal, exist, defect, disappear, fall, die, flee, attack, break, leave
Skype	skype, call, jump, speak, phone, text, talk, communicate, disconnect, telephone
grease	move, die, fall, eat, vomit, react, crash, explode, happen, bleed
compress	compress, deform, move, change, shrink, fold, collapse, grow, distort, expand
blank	exist, scream, laugh, die, appear, jump, kill, speak, move, react
forgot	die, exist, occur, fall, appear, happen, suffer, move, attack, perish
without	exist, fail, die, occur, fall, happen, disappear, appear, stop, break
heard	die, exist, appear, fall, occur, suffer, move, happen, speak, react
or	exist, die, occur, happen, suffer, do, be, appear, fall, kill
good	suffer, die, harm, exist, succeed, fail, fall, do, improve, behave
heart	heart, die, hate, exist, cry, act, happen, love, do, attack
WANT	exist, die, happen, attack, do, be, react, move, act, appear
subpoena	testify, appear, disappear, resign, comply, subpoena, die, object, act, lie
prolong	die, suffer, exist, perish, stop, occur, fail, delay, disappear, fall
USE	exist, die, appear, attack, be, happen, occur, react, move, do
mint	die, exist, fall, appear, suffer, occur, perish, move, happen, speak
disgrace	suffer, disgrace, die, fail, perish, defect, harm, fall, resign, lose
multiply	multiply, increase, divide, decrease, grow, double, subtract, exist, rise, occur
fulfil	exist, happen, occur, succeed, fulfil, act, live, work, perform, fail
chart	occur, exist, happen, move, change, appear, do, stop, rise, die
undergo	die, exist, occur, appear, suffer, happen, fall, change, perish, live
jerk	jerk, move, react, object, jump, hurt, laugh, stop, act, behave
cheat	cheat, fail, lose, die, lie, deceive, win, defect, suffer, steal
anticipate	occur, happen, anticipate, react, appear, respond, exist, do, act, predict
invoke	appear, speak, exist, occur, invoke, arise, happen, act, respond, react
corner	flee, attack, fight, leave, intervene, fall, move, retaliate, escape, disappear
READ	die, exist, fall, suffer, appear, occur, react, move, speak, attack
author	write, exist, succeed, create, happen, occur, appear, die, act, do
conduct	conduct, behave, occur, act, do, exist, harm, happen, respond, interfere
lap	fall, jump, move, stumble, stop, pass, react, vomit, roll, crash
rise	die, exist, fall, appear, occur, suffer, perish, happen, move, live
craft	exist, create, produce, craft, happen, work, do, fail, evolve, appear
image	appear, exist, image, change, look, think, move, object, act, react
till	die, exist, fall, appear, suffer, occur, perish, happen, move, live
slur	slur, spit, speak, scream, blush, vomit, shout, laugh, yell, apologize
table	die, exist, occur, fall, appear, suffer, move, happen, attack, react
prohibit	object, exist, cease, act, fail, stop, offend, occur, interfere, suffer
train	train, fail, succeed, learn, work, suffer, defect, change, die, exist
remind	respond, react, remember, speak, think, appear, forget, stop, laugh, notice
staff	fail, occur, work, fire, lose, exist, harm, attack, intervene, leave
resign	resign, leave, quit, die, fall, defect, change, lose, go, fail
misinterpret	misunderstand, misinterpret, interpret, disagree, speak, deceive, react, differ, lie, change
pet	laugh, pet, jump, smile, bite, cry, stop, behave, respond, touch
clock	clock, jump, sleep, die, move, run, do, blink, stop, react
screen	screen, fail, respond, appear, jump, react, fire, act, flee, watch
likely	die, exist, fall, occur, appear, suffer, happen, perish, move, attack
omit	omit, appear, disappear, exist, occur, fail, vanish, lie, change, miss
tan	die, exist, fall, appear, suffer, move, kill, attack, occur, harm
eventually	die, exist, occur, happen, kill, fail, do, perish, succeed, fall
evaluate	evaluate, fail, act, respond, exist, improve, complain, change, react, suffer
survived	die, exist, fall, occur, appear, suffer, happen, move, perish, react
coat	coat, appear, fall, react, bite, bleed, vomit, occur, change, exist
disband	die, exist, fall, occur, appear, perish, suffer, attack, happen, disappear
overshadow	dominate, succeed, appear, lose, suffer, disappear, fail, overshadow, stumble, occur
warn	panic, respond, intervene, react, flee, fear, act, worry, speak, think
blister	die, exist, fall, appear, suffer, move, occur, react, attack, perish
cane	fall, die, stumble, strike, appear, fight, hurt, harm, move, speak
ruined	die, exist, fall, suffer, occur, appear, perish, happen, move, live
vent	vent, complain, cry, speak, scream, rant, rage, shout, erupt, yell
obscure	appear, obscure, disappear, hide, exist, occur, confuse, speak, stumble, vanish
drill	explode, drill, fall, die, scream, hurt, jump, strike, move, fail
See	exist, appear, die, happen, occur, see, do, be, move, attack
paper	die, fall, exist, move, occur, attack, suffer, appear, harm, kill
excise	exist, disappear, appear, change, occur, die, defect, suffer, vanish, differ
livestream	livestream, drown, broadcast, watch, exist, disappear, die, post, appear, vomit
exchange	exchange, exist, trade, leave, change, swap, return, occur, give, defect
term	exist, occur, appear, speak, object, name, be, differ, happen, change
refill	die, exist, fall, suffer, appear, occur, move, react, perish, attack
tighten	tighten, move, loosen, buckle, choke, snap, break, react, twitch, squeeze
prosper	die, exist, suffer, perish, fall, live, appear, occur, happen, succeed
reign	die, exist, occur, appear, fall, happen, suffer, perish, attack, move
oil	die, fall, move, explode, suffer, exist, react, kill, attack, appear
tend	tend, die, do, suffer, behave, occur, harm, act, sleep, care
fan	fall, die, cry, fly, scream, faint, move, rise, react, burn
tread	die, fall, exist, kill, occur, cross, move, harm, attack, appear
suspend	suspend, fall, fail, die, suffer, disappear, occur, stop, object, resign
law	die, exist, fall, suffer, occur, perish, appear, happen, kill, fail
manipulate	change, behave, act, suffer, defect, react, manipulate, exist, die, harm
comb	fight, fall, bite, attack, wrestle, change, appear, behave, move, strike
interrupt	interrupt, stop, speak, interfere, intervene, respond, object, leave, shout, react
identity	exist, appear, identify, disappear, occur, change, vanish, identity, die, be
derail	fail, derail, crash, fall, die, occur, succeed, happen, stumble, suffer
pace	pace, stop, accelerate, move, speed, walk, slow, fall, run, stumble
mar	die, marry, harm, drown, bleed, hurt, fall, suffer, object, mar
slash	die, fall, slash, bleed, strike, scream, hurt, bite, attack, kill
curb	stop, change, react, behave, harm, act, suffer, intervene, fall, fail
remain	change, exist, disappear, die, vanish, remain, be, perish, end, appear
palm	fall, die, fight, appear, harm, attack, move, hurt, suffer, cry
bug	complain, attack, panic, react, respond, behave, leave, die, occur, talk
lob	fall, die, object, hit, explode, move, jump, attack, harm, exist
conceive	conceive, exist, reproduce, die, appear, occur, arise, live, produce, develop
ad	exist, die, fall, occur, appear, speak, attack, harm, fight, object
man	die, kill, fall, exist, attack, appear, man, move, do, harm
insure	die, insure, survive, fail, suffer, perish, succeed, live, exist, occur
appeal	appeal, respond, react, appear, object, act, complain, speak, change, fall
peak	die, exist, fall, appear, suffer, occur, move, react, speak, attack
tempt	act, flee, behave, fall, resist, choose, suffer, appear, think, move
render	appear, render, change, exist, fall, die, disappear, occur, transform, move
vest	die, exist, fall, appear, suffer, occur, move, perish, react, attack
here	exist, die, occur, leave, happen, arrive, fall, disappear, appear, move
solo	die, fall, exist, appear, suffer, move, occur, react, attack, speak
speed	speed, accelerate, react, move, slow, run, stop, race, jump, crash
deposit	deposit, exist, disappear, die, leave, move, object, fall, occur, vanish
automate	fail, automate, occur, malfunction, crash, work, stop, behave, happen, exist
fence	fence, cross, jump, flee, move, die, fall, run, trespass, leave
skew	skew, change, lose, win, occur, fail, fall, lie, suffer, die
limp	die, exist, fall, suffer, appear, move, occur, speak, react, attack
whiff	die, exist, fall, appear, suffer, move, react, occur, attack, speak
even	die, exist, kill, suffer, fall, harm, occur, object, attack, happen
override	fail, occur, change, interfere, override, exist, intervene, happen, object, succeed
commute	die, exist, occur, suffer, move, happen, fall, appear, fail, object
inspect	look, inspect, fail, appear, object, stop, observe, fall, act, react
finally	die, exist, fall, occur, suffer, appear, happen, perish, move, attack
reduce	decrease, reduce, increase, diminish, grow, suffer, exist, shrink, change, fall
grace	appear, occur, exist, fall, suffer, die, behave, happen, react, succeed
shutter	shutter, disappear, scream, panic, die, flee, shoot, jump, vanish, appear
scramble	die, move, fall, react, jump, appear, occur, exist, attack, fail
litter	litter, fall, die, occur, suffer, vomit, harm, leave, appear, fail
then	die, occur, exist, happen, do, kill, fail, be, change, fall
spam	spam, respond, retaliate, complain, occur, harm, react, exist, attack, behave
prank	laugh, retaliate, die, suffer, harm, behave, occur, react, respond, panic
bare	die, fall, exist, move, appear, attack, suffer, harm, kill, react
rack	attack, fall, react, hit, fight, knock, occur, strike, die, suffer
spite	suffer, retaliate, lose, complain, offend, rage, harm, act, hate, die
coax	appear, behave, move, speak, act, intervene, come, cooperate, resist, laugh
cold	die, fall, exist, suffer, appear, perish, move, occur, attack, react
skill	die, fail, fall, succeed, exist, attack, kill, occur, move, do
cup	fall, die, vomit, hurt, exist, cry, appear, scream, object, move
proved	die, exist, appear, occur, fall, suffer, happen, perish, speak, move
suppose	exist, suppose, occur, appear, believe, think, happen, act, be, change
disrupt	disrupt, occur, interfere, react, harm, suffer, intervene, appear, act, happen
eating	die, eat, starve, kill, suffer, attack, exist, fall, bite, death
mold	change, mold, grow, evolve, transform, deform, develop, break, behave, move
misunderstand	misunderstand, speak, disagree, differ, understand, react, offend, misinterpret, mislead, think
day	die, exist, happen, occur, fail, appear, disappear, change, stop, fall
elbow	fall, stumble, strike, move, object, punch, laugh, shout, hit, intervene
harbor	harbor, exist, harm, steal, attack, suffer, possess, flee, kill, live
really	exist, die, occur, happen, fall, object, appear, be, speak, change
tune	change, react, speak, run, stop, tune, do, sing, whine, move
tally	die, exist, fall, appear, suffer, occur, move, attack, perish, speak
shield	flee, fall, hide, harm, retreat, appear, move, disappear, shield, suffer
hurry	hurry, delay, rush, stop, move, accelerate, speed, appear, jump, react
crushed	die, exist, fall, appear, suffer, occur, move, perish, happen, react
square	square, move, collide, turn, cross, intersect, fall, grow, jump, roll
started	die, exist, fall, occur, appear, suffer, happen, move, perish, react
cum	die, exist, fall, appear, suffer, occur, perish, move, react, attack
rally	rally, rise, fight, react, flee, lose, respond, intervene, win, fall
balance	balance, fall, move, grow, rise, collide, fail, break, increase, occur
select	choose, select, change, exist, occur, appear, succeed, die, win, act
prioritize	prioritize, suffer, win, lose, benefit, succeed, fail, dominate, occur, exist
took	die, exist, fall, appear, occur, suffer, move, happen, perish, attack
pan	die, fall, move, react, attack, appear, exist, jump, happen, kill
aim	shoot, aim, hit, fall, fire, miss, strike, move, explode, fail
mirror	appear, change, exist, move, transform, evolve, react, behave, grow, occur
bounce	bounce, fall, jump, hit, move, fly, drop, swing, bump, laugh
minimize	suffer, diminish, increase, decrease, grow, exist, reduce, minimize, shrink, occur
bid	bid, win, refuse, lose, die, respond, do, object, pay, cry
configure	fail, crash, run, behave, change, work, configure, occur, default, malfunction
salt	die, exist, fall, suffer, appear, move, occur, perish, attack, kill
scent	smell, scent, jump, move, react, appear, blush, sniff, stink, vomit
red	die, fall, attack, fight, kill, react, exist, harm, appear, cry
import	import, exist, arrive, appear, occur, disappear, change, happen, defect, suffer
pause	pause, stop, react, delay, interrupt, halt, respond, speak, jump, hesitate
black	die, black, color, bleed, change, kill, appear, move, exist, burn
substitute	exist, occur, change, substitute, appear, fail, disappear, differ, defect, happen
compromise	compromise, suffer, defect, fail, fall, harm, die, change, lose, interfere
arrive	arrive, appear, occur, exist, die, come, happen, leave, disappear, return
feature	appear, exist, feature, occur, change, disappear, happen, move, be, object
great	die, exist, suffer, fall, perish, occur, appear, fail, happen, succeed
felt	die, exist, fall, appear, occur, suffer, move, happen, react, perish
hedge	die, exist, occur, appear, fall, happen, suffer, fail, move, attack
managed	die, exist, appear, fall, occur, suffer, move, happen, speak, react
eject	eject, leave, flee, object, fall, move, die, disappear, appear, depart
discourage	act, withdraw, complain, leave, suffer, harm, fail, change, stop, behave
reinforce	change, react, occur, reinforce, increase, respond, grow, exist, behave, improve
compound	multiply, compound, occur, exist, change, arise, appear, grow, increase, differ
enough	die, exist, fall, suffer, appear, occur, perish, move, attack, live
incorporate	exist, occur, appear, change, differ, disappear, overlap, evolve, happen, merge
strap	fall, hurt, strap, buckle, jump, stumble, harm, bind, break, injure
infiltrate	infiltrate, exist, defect, flee, occur, escape, attack, interfere, enter, disappear
ize	exist, speak, object, appear, change, occur, talk, slur, understand, disappear
evade	evade, escape, flee, disappear, fail, appear, move, defect, run, vanish
assure	believe, occur, die, appear, intervene, fail, fear, act, speak, happen
triumph	die, exist, fall, perish, suffer, appear, occur, happen, live, kill
distinguish	differ, appear, exist, distinguish, occur, differentiate, change, separate, speak, move
rend	die, break, rend, fall, suffer, exist, harm, flee, hurt, burn
ply	die, exist, fall, suffer, appear, occur, move, perish, attack, react
Photoshop	photoshop, appear, exist, change, disappear, edit, suffer, crash, fall, lie
impress	appear, smile, act, impress, respond, behave, blush, succeed, change, notice
bin	die, exist, occur, fall, attack, appear, move, happen, object, disappear
diagnose	die, suffer, diagnose, exist, appear, occur, act, live, behave, respond
se	die, exist, fall, occur, suffer, appear, happen, perish, move, attack
duck	duck, move, cross, jump, speak, drown, fall, object, laugh, react
escort	leave, appear, intervene, fall, flee, object, disappear, die, stop, move
intensify	die, exist, appear, fall, suffer, occur, move, react, speak, attack
plaster	die, fall, exist, appear, suffer, occur, move, attack, happen, react
gun	shoot, die, fire, kill, run, shot, fall, harm, death, flee
morph	morph, change, transform, evolve, appear, move, disappear, exist, grow, vanish
wrote	die, exist, fall, occur, appear, suffer, happen, perish, move, speak
Buy	die, exist, fall, occur, suffer, appear, move, happen, perish, react
shower	shower, vomit, appear, drown, drink, sweat, pee, orgasm, cum, flood
hog	hog, eat, attack, vomit, bite, die, suffer, exist, kill, choke
actually	exist, occur, happen, die, appear, be, act, change, do, object
real	exist, die, happen, change, occur, appear, be, kill, disappear, move
scorn	hate, scorn, ridicule, insult, laugh, suffer, complain, despise, offend, dislike
into	fall, die, change, exist, move, disappear, appear, break, transform, turn
weep	weep, cry, suffer, sob, tear, bleed, mourn, drink, die, scream
greet	smile, appear, respond, laugh, greet, react, arrive, speak, cheer, enter
dock	exist, move, attack, do, object, fail, fight, happen, fall, harm
ha	die, exist, fall, appear, occur, suffer, happen, move, perish, attack
punk	die, attack, harm, kill, fall, exist, fight, jump, react, suffer
shame	suffer, shame, blush, cry, laugh, harm, lose, ridicule, retaliate, behave
loves	die, exist, love, hate, kill, leave, suffer, change, live, fight
fruit	die, exist, fall, suffer, appear, occur, perish, move, attack, happen
undertake	undertake, do, occur, exist, act, fail, die, succeed, suffer, kill
impose	change, exist, suffer, act, fail, disappear, impose, succeed, appear, prevail
rate	improve, rate, score, fall, rise, rank, win, succeed, complain, perform
hop	die, exist, fall, appear, suffer, occur, move, attack, react, perish
exercise	exercise, move, work, suffer, perform, act, react, behave, respond, object
vow	die, exist, fall, appear, suffer, occur, move, perish, react, speak
sanction	suffer, die, act, fail, sanction, exist, perish, defect, kill, object
assert	assert, exist, claim, lie, disagree, object, act, respond, occur, speak
bought	die, exist, fall, occur, suffer, happen, appear, perish, move, fail
bypass	fail, pass, cheat, succeed, win, interfere, lose, occur, die, exist
audit	audit, fail, cheat, lie, investigate, corrupt, report, complain, act, stumble
schedule	occur, cancel, schedule, appear, work, fail, arrive, miss, happen, come
discern	distinguish, appear, discern, perceive, exist, see, sense, know, recognize, speak
transplant	die, exist, defect, reproduce, change, transplant, survive, perish, live, fail
named	exist, occur, die, appear, speak, change, happen, disappear, be, move
tidy	tidy, clean, behave, do, appear, object, upset, vacuum, act, look
dash	dash, die, jump, move, crash, fall, run, explode, disappear, collide
convict	die, flee, convict, suffer, escape, defect, murder, confess, fall, believe
avert	appear, die, flee, occur, exist, escape, happen, react, perish, disappear
only	exist, die, object, disappear, occur, suffer, fail, appear, change, perish
toe	die, exist, fall, occur, suffer, appear, happen, attack, move, fail
calm	calm, relax, panic, react, stop, behave, scream, move, fear, speak
estimate	estimate, occur, exist, grow, lie, increase, fall, guess, move, be
evolve	evolve, change, exist, occur, appear, arise, grow, develop, die, emerge
disarm	disarm, die, react, flee, attack, explode, act, fall, panic, harm
tee	die, fall, exist, suffer, appear, move, perish, occur, attack, react
simplify	simplify, change, improve, appear, differ, exist, suffer, fail, multiply, increase
now	die, exist, change, happen, occur, do, appear, react, stop, perish
itch	itch, scratch, bite, sting, bleed, hurt, cry, vomit, move, scream
string	fall, jump, string, hurt, do, object, sting, happen, bite, break
OWN	die, exist, suffer, fall, appear, occur, kill, attack, move, react
slate	die, exist, fall, suffer, appear, occur, attack, kill, harm, perish
blows	die, fall, explode, kill, attack, strike, move, fight, hit, occur
using	exist, use, occur, fail, be, harm, die, do, happen, object
contract	contract, pay, object, die, act, bite, exist, strike, change, defect
brain	brain, die, think, react, speak, talk, behave, kill, mind, suffer
bunk	die, exist, fall, suffer, appear, occur, perish, move, attack, react
breath	breathe, breath, cough, die, speak, smoke, choke, vomit, move, scream
stem	die, exist, appear, occur, fall, suffer, happen, move, perish, speak
transfer	transfer, change, move, shift, leave, disappear, die, exist, switch, occur
purge	purge, disappear, die, perish, vanish, consume, suffer, vomit, leave, exist
quantify	exist, increase, quantify, occur, multiply, measure, grow, change, reduce, decrease
slim	die, kill, fall, drown, vomit, jump, choke, move, harm, appear
caught	die, exist, fall, appear, occur, suffer, move, happen, react, attack
assess	act, fail, react, respond, behave, assess, evaluate, exist, suffer, differ
hone	die, exist, occur, suffer, appear, fall, happen, fail, perish, speak
act	act, react, behave, do, appear, happen, occur, exist, die, action
grip	move, fall, shake, snap, scream, bite, object, react, hurt, grip
lump	lump, move, fall, object, occur, exist, stumble, cross, suffer, slur
reply	reply, respond, answer, react, object, return, disagree, speak, retaliate, complain
hashtag	tweet, respond, retweet, react, exist, reply, disappear, retaliate, comment, post
teleport	teleport, appear, move, vanish, disappear, jump, die, flee, escape, leave
reuse	reuse, change, exist, occur, reproduce, fail, use, disappear, die, work
scoff	die, fall, attack, exist, react, laugh, speak, suffer, appear, occur
dope	dope, die, overdose, smoke, suffer, drink, use, cheat, do, crash
short	fall, short, lose, fail, pay, complain, stop, speak, suffer, die
edge	edge, lose, fall, react, move, fight, cheat, die, attack, hurt
paste	paste, copy, disappear, exist, appear, duplicate, fail, occur, reproduce, print
idea	die, exist, occur, happen, fall, appear, suffer, attack, move, perish
gum	die, fall, exist, suffer, appear, move, react, attack, occur, speak
negate	exist, disappear, negate, vanish, die, occur, appear, change, fail, suffer
graffiti	die, exist, harm, attack, fall, appear, disappear, fight, kill, defect
testify	testify, lie, appear, believe, speak, die, exist, respond, confess, answer
filibuster	die, exist, fall, suffer, appear, occur, attack, perish, move, react
mentioned	die, exist, occur, fall, appear, suffer, happen, move, speak, attack
sigh	die, exist, fall, appear, suffer, occur, move, react, speak, attack
spear	fall, die, attack, fight, kill, hurt, strike, flee, harm, jump
net	die, exist, win, vanish, lose, kill, succeed, disappear, happen, appear
educate	learn, succeed, understand, speak, benefit, think, teach, improve, suffer, educate
later	die, exist, occur, fall, happen, suffer, appear, perish, fail, kill
clue	speak, respond, appear, talk, know, react, lie, sleep, communicate, answer
replay	die, exist, appear, react, move, occur, speak, fall, attack, disappear
able	die, exist, appear, fall, occur, suffer, happen, move, perish, speak
leg	die, fall, kill, exist, move, harm, attack, suffer, fail, jump
him	die, exist, suffer, do, harm, act, be, happen, occur, appear
frequent	exist, occur, visit, die, behave, leave, appear, interact, return, do
cultivate	grow, succeed, exist, flourish, prosper, develop, evolve, arise, appear, thrive
propel	move, accelerate, jump, propel, fall, occur, rise, happen, do, leap
wearing	die, exist, fall, move, occur, appear, suffer, attack, harm, disappear
awake	awaken, wake, sleep, awake, rise, appear, arise, move, speak, stir
jar	jump, move, hurt, explode, scream, jar, fall, stumble, object, react
cuff	cuff, stop, resist, fall, hurt, jump, strike, choke, appear, object
Eat	die, exist, fall, attack, occur, appear, move, suffer, happen, kill
ve	die, exist, fall, appear, suffer, occur, move, perish, happen, react
first	die, exist, respond, kill, fail, occur, happen, succeed, attack, react
sprint	die, exist, fall, appear, move, suffer, occur, react, attack, speak
garner	die, exist, suffer, fall, appear, occur, perish, attack, happen, move
leverage	exist, move, do, fail, fall, leverage, die, succeed, happen, attack
total	die, exist, fall, appear, suffer, occur, perish, move, disappear, kill
ruins	die, exist, fall, appear, suffer, occur, perish, move, happen, attack
prompt	react, respond, act, speak, appear, occur, move, behave, intervene, think
wander	wander, walk, stumble, move, cross, disappear, exist, leave, turn, fall
age	die, age, decline, change, grow, mature, suffer, live, move, develop
reset	reset, change, react, die, malfunction, fail, switch, move, occur, crash
broaden	exist, die, occur, appear, fall, suffer, change, move, happen, speak
line	cross, fall, move, jump, run, die, occur, hit, react, happen
wage	die, exist, suffer, fall, occur, kill, perish, fail, attack, appear
phase	react, respond, object, move, act, change, appear, occur, speak, panic
Find	die, exist, fall, appear, occur, suffer, move, attack, happen, perish
export	export, exist, leave, disappear, defect, produce, occur, appear, happen, change
splash	splash, drown, vomit, fall, jump, scream, appear, die, swim, cry
ding	ding, bite, hit, strike, fight, do, hurt, stumble, retaliate, complain
friend	befriend, friend, exist, laugh, die, friendship, cooperate, like, do, behave
spice	die, exist, fall, suffer, appear, occur, move, react, speak, perish
still	change, move, die, stop, occur, exist, appear, happen, speak, do
rear	rear, die, fight, occur, return, exist, attack, flee, suffer, kill
cage	fight, die, escape, attack, bite, harm, flee, fall, exist, strike
fault	fail, fault, complain, blame, suffer, defect, err, lose, fall, offend
ever	die, exist, occur, happen, kill, change, appear, fail, fall, live
invade	invade, enter, leave, die, attack, flee, fall, disappear, exist, intervene
broken	die, exist, fall, suffer, appear, occur, move, happen, perish, attack
penetrate	penetrate, fall, die, enter, escape, exist, break, flee, orgasm, bleed
distract	distract, appear, react, think, flee, panic, act, speak, move, behave
goddamn	die, exist, fall, suffer, occur, appear, happen, move, react, attack
map	map, move, appear, exist, disappear, vanish, change, occur, teleport, cross
stack	stack, fall, move, rise, overflow, collapse, pile, climb, fail, crash
attach	attach, detach, fall, move, jump, object, escape, occur, disappear, exist
comp	die, exist, fall, occur, suffer, appear, move, happen, speak, attack
humor	laugh, smile, chuckle, blush, respond, react, grin, joke, amuse, humor
reckon	think, exist, suffer, occur, do, change, die, happen, appear, be
troll	troll, respond, tweet, retaliate, laugh, react, reply, complain, comment, exist
herald	exist, appear, occur, die, succeed, triumph, happen, fall, perish, arise
t	die, speak, object, exist, react, bite, occur, do, stop, t
flame	burn, die, flame, fire, combust, explode, ignite, jump, fall, flee
exclaim	die, exist, appear, fall, occur, speak, suffer, move, react, happen
stump	fall, stumble, fight, stump, speak, move, lose, jump, attack, appear
sandwich	die, fall, move, exist, attack, appear, bite, eat, disappear, break
interview	speak, appear, talk, exist, respond, lie, answer, interview, report, die
joke	laugh, joke, chuckle, smile, react, ridicule, respond, lie, talk, speak
fashion	appear, exist, fashion, change, grow, occur, reproduce, behave, wear, do
prime	die, do, exist, jump, move, rise, object, kill, attack, accelerate
truck	die, fall, exist, move, occur, suffer, kill, appear, happen, attack
archive	exist, disappear, archive, delete, die, copy, object, appear, react, vanish
house	exist, live, reside, move, appear, occur, survive, die, reproduce, suffer
blitz	die, fall, exist, suffer, appear, move, react, attack, occur, speak
soil	die, fall, drown, soil, suffer, fail, vomit, sink, hurt, harm
pledge	pledge, die, lose, do, commit, exist, defect, pay, win, forfeit
customize	change, exist, appear, behave, occur, fail, die, react, object, evolve
appoint	resign, succeed, appoint, act, exist, serve, die, occur, appear, rise
am	exist, appear, die, be, occur, suffer, attack, act, differ, change
father	die, reproduce, exist, fail, conceive, marry, parent, kill, suffer, succeed
elevate	rise, fall, suffer, decline, succeed, elevate, ascend, improve, exist, diminish
parade	parade, appear, exist, occur, fall, fight, defect, die, dance, object
apprehend	flee, appear, escape, apprehend, act, disappear, die, exist, suffer, fall
chair	die, fall, move, exist, appear, suffer, occur, speak, object, attack
flesh	die, exist, fall, suffer, appear, perish, occur, kill, move, attack
booze	drink, vomit, die, harm, drunk, do, fight, kill, drown, cry
sequence	occur, react, move, sequence, interfere, exist, jump, change, appear, happen
withhold	withhold, refuse, withdraw, steal, disappear, harm, fail, leave, suffer, resist
wound	die, suffer, hurt, fall, bleed, kill, wound, harm, bite, injure
finds	die, exist, fall, occur, appear, happen, suffer, perish, move, disappear
specify	exist, appear, occur, change, specify, happen, object, disappear, be, fail
escalate	escalate, react, intervene, occur, rise, respond, retaliate, fight, die, happen
massacre	die, kill, perish, murder, suffer, attack, massacre, occur, death, flee
says	speak, exist, say, occur, respond, talk, happen, laugh, reply, appear
horde	die, exist, fall, appear, suffer, attack, occur, perish, move, kill
life	die, exist, live, life, perish, suffer, death, occur, survive, arise
rifle	shoot, die, fire, kill, attack, explode, fall, fight, shot, run
bitch	bitch, cry, scream, complain, laugh, yell, retaliate, hit, rage, whine
belt	fall, strike, belt, buckle, choke, object, hurt, fight, hit, stop
compliment	smile, laugh, respond, blush, reply, react, apologize, comment, compliment, complain
fret	die, suffer, exist, fall, appear, react, move, occur, speak, attack
built	die, exist, occur, fall, appear, happen, suffer, move, perish, live
weight	weigh, fall, gain, move, weight, die, lose, suffer, grow, rise
believed	die, exist, fall, appear, suffer, occur, move, perish, happen, speak
relate	relate, occur, exist, differ, appear, speak, happen, respond, react, behave
unite	unite, exist, separate, divide, split, join, perish, merge, occur, appear
long	die, fall, exist, speak, harm, attack, suffer, fail, stop, move
hard	die, exist, fall, suffer, appear, occur, perish, attack, kill, move
affirm	affirm, believe, exist, change, respond, live, occur, act, appear, react
us	exist, suffer, us, occur, happen, die, harm, do, be, act
floor	die, fall, move, suffer, appear, exist, attack, react, flee, object
fax	fax, write, respond, exist, communicate, call, die, text, email, do
board	board, leave, cross, defect, jump, crash, flee, die, fail, go
camouflage	appear, hide, disappear, camouflage, deceive, vanish, disguise, exist, move, lie
roof	die, fall, exist, suffer, appear, occur, perish, move, attack, kill
losing	die, lose, disappear, perish, fall, exist, suffer, leave, occur, death
writing	exist, die, occur, write, happen, kill, fail, attack, succeed, disappear
word	speak, occur, say, exist, appear, happen, sound, talk, object, word
redirect	redirect, react, respond, intervene, occur, behave, act, change, fail, move
sees	die, exist, appear, fall, occur, move, attack, happen, react, suffer
lodge	exist, die, occur, appear, fall, attack, kill, move, suffer, happen
SIGN	die, exist, fall, appear, suffer, occur, move, react, speak, attack
commission	exist, succeed, die, kill, defect, act, appear, occur, fail, pay
mother	die, suffer, reproduce, exist, perish, cry, kill, harm, occur, grow
might	exist, object, do, move, die, appear, suffer, speak, react, think
fracture	fracture, break, fall, die, collapse, suffer, hurt, shatter, fail, weaken
tone	speak, tone, cry, react, scream, yell, shout, respond, change, talk
dive	fall, die, jump, drown, move, crash, attack, exist, disappear, hit
behind	die, fall, exist, suffer, appear, occur, move, perish, happen, attack
breeze	die, fall, exist, suffer, appear, occur, move, attack, react, perish
vape	vape, vomit, smoke, die, drink, explode, laugh, fire, react, orgasm
offset	occur, change, lose, increase, compensate, offset, exist, move, fail, disappear
equate	exist, differ, occur, offend, speak, suffer, appear, disagree, change, object
mentor	succeed, improve, learn, benefit, excel, work, grow, mentor, fail, change
brainstorm	die, exist, occur, happen, appear, speak, move, fall, attack, fail
embed	exist, disappear, die, appear, do, interfere, occur, change, move, break
feast	die, exist, fall, suffer, appear, occur, perish, move, attack, react
improv	die, exist, fall, appear, suffer, occur, move, react, happen, speak
loan	borrow, lend, loan, give, steal, pay, object, do, leave, exist
delegate	delegate, fail, complain, occur, leave, object, act, refuse, lose, disagree
exist	exist, exists, appear, occur, existence, arise, live, existed, be, happen
luck	die, exist, fall, suffer, appear, occur, happen, move, perish, react
cull	die, kill, perish, attack, flee, exist, disappear, eat, cull, harm
blackmail	flee, die, defect, suffer, disappear, blackmail, kill, steal, resign, lie
strength	die, exist, fall, suffer, appear, occur, perish, move, attack, happen
instruct	speak, act, fail, instruct, behave, obey, intervene, respond, appear, think
stolen	die, exist, fall, suffer, occur, appear, perish, happen, attack, kill
having	exist, die, occur, happen, be, appear, suffer, live, kill, have
designed	die, exist, appear, fall, occur, suffer, happen, move, speak, perish
ticket	pay, lose, stop, complain, fight, fail, ticket, cross, object, die
reload	reload, fire, explode, shoot, die, react, crash, attack, run, move
assault	flee, attack, fight, retaliate, assault, fall, harm, die, resist, object
rep	exist, object, do, defect, act, suffer, occur, reproduce, rep, change
transcend	exist, transcend, appear, disappear, change, transform, arise, occur, manifest, vanish
nominate	nominate, win, vote, appear, succeed, exist, lose, participate, occur, die
humble	suffer, fail, fall, stumble, humble, speak, lose, harm, rise, complain
trail	die, trail, disappear, fall, appear, run, move, jump, flee, follow
motivate	succeed, act, work, behave, think, respond, motivate, react, exist, rise
pulp	die, exist, fall, suffer, appear, occur, move, perish, attack, react
thumb	suck, thumb, hit, bite, do, bleed, stumble, move, swing, turn
forecast	die, exist, appear, occur, fall, suffer, happen, perish, move, attack
assign	exist, occur, assign, die, change, act, happen, fail, suffer, do
this	exist, occur, die, happen, be, suffer, this, appear, object, do
hated	hate, die, exist, suffer, kill, despise, attack, dislike, change, fight
dip	dip, drown, fall, vomit, drop, jump, sink, slip, die, drink
rebound	die, exist, fall, suffer, appear, occur, move, perish, attack, react
lean	fall, die, move, exist, attack, occur, speak, suffer, fail, object
against	die, attack, harm, retaliate, suffer, exist, fight, fall, lose, fail
level	fall, level, fail, drop, rise, jump, die, move, lose, succeed
bus	die, fall, exist, move, occur, appear, suffer, fail, happen, attack
sub	sub, die, defect, exist, fall, change, kill, speak, suffer, occur
button	button, cry, do, bleed, move, appear, look, react, hit, blink
sweet	die, exist, suffer, fall, appear, occur, perish, react, attack, move
wine	die, fall, exist, suffer, appear, perish, occur, move, kill, attack
bundle	die, exist, fall, occur, suffer, appear, move, perish, disappear, happen
insist	object, refuse, insist, resist, disagree, complain, change, behave, respond, comply
all	exist, die, occur, change, fail, happen, kill, disappear, be, stop
please	suffer, succeed, exist, behave, benefit, occur, appear, harm, act, please
cease	die, exist, occur, appear, suffer, fall, perish, happen, speak, attack
pad	die, fall, move, exist, occur, object, attack, speak, react, suffer
staunch	die, exist, fall, suffer, appear, move, occur, perish, react, attack
rupture	rupture, break, fracture, explode, collapse, dissolve, fall, die, shatter, burst
needing	die, exist, fall, occur, suffer, appear, happen, move, perish, fail
effect	act, occur, happen, appear, exist, suffer, change, react, behave, effect
deport	leave, flee, disappear, deport, die, go, defect, return, move, suffer
consult	consult, speak, appear, act, think, occur, intervene, respond, disagree, interfere
known	die, exist, appear, occur, kill, attack, happen, speak, fall, move
behave	behave, act, react, do, appear, occur, happen, suffer, perform, exist
knife	die, kill, bleed, fall, bite, attack, hurt, harm, fight, murder
knee	fall, strike, kick, move, hurt, hit, die, stop, object, stumble
was	die, exist, occur, appear, fall, suffer, happen, perish, attack, move
expense	die, exist, suffer, fall, appear, occur, perish, fail, move, attack
axe	die, fall, kill, strike, attack, harm, explode, jump, disappear, bleed
drug	overdose, die, drink, harm, drug, suffer, use, kill, smoke, steal
tick	tick, react, move, laugh, bite, jump, respond, blink, behave, act
regretted	die, exist, fall, suffer, appear, occur, perish, move, happen, react
accommodate	accommodate, change, exist, comply, move, suffer, occur, behave, act, object
because	exist, happen, occur, die, do, be, stop, appear, kill, act
attest	die, exist, appear, suffer, occur, fall, perish, happen, move, kill
elect	win, succeed, exist, lose, die, vote, prevail, rule, rise, run
warp	warp, move, change, jump, deform, distort, malfunction, break, turn, spin
echo	echo, speak, occur, appear, sound, laugh, repeat, talk, respond, exist
takes	die, exist, fall, occur, appear, suffer, happen, move, perish, attack
magic	die, exist, fall, appear, suffer, occur, move, perish, happen, attack
home	die, harm, happen, hit, occur, do, attack, fall, leave, kill
relocate	relocate, move, flee, leave, disappear, occur, change, vanish, disperse, react
yet	die, exist, occur, happen, fall, appear, suffer, fail, move, perish
as	exist, appear, occur, die, be, speak, happen, change, object, disappear
dice	die, fall, move, kill, strike, hit, attack, jump, fail, bite
case	occur, happen, appear, exist, die, disappear, fall, do, fail, succeed
wolf	die, exist, fall, suffer, appear, occur, perish, attack, move, kill
legal	die, exist, fall, suffer, occur, perish, appear, happen, kill, attack
thrive	die, exist, suffer, occur, fall, appear, perish, happen, live, move
emit	emit, exist, react, appear, occur, transmit, explode, manifest, behave, jump