die	death, day, date, deadline, dying
win	win, winning, won
be	birthday, being, be
survive	survival, surviving, survive, success
fail	failure, fail, failing, failures
succeed	success, successful
live	life, longevity, lifespan
pass	pass, passing, period
do	day, do, deadline, date
cry	crying, cry, crisis
know	knowing, know, knowledge, known, knew
fall	fall, falling, failure, fracture, falls
work	work
leave	leaving, leave
not	
come	coming, christmas
return	return, returning, recovery, restoration
lose	loss, losing, lose, losses
stay	stay, staying, stable
bite	bite, biting, bitten, breach, bites
tell	tell, time, tale, telling, that, this, trust, told
answer	answer, affirmative, argument, a, agreement
try	try, test, trying, tries, this, that
explode	explosion, explosive, emergency, eruption, event, earthquake, exploding, explode
disappear	disappearance, deadline, day, death, disappearing
go	go
fly	fly, flight, flying, fall, formation
happen	
help	help, helping, helpful, helps
run	run, race, riot, running, runs
respond	response, reaction, responding, respond, reflex, responsiveness, react, reacting
sue	suit, strike, sue, suing, sued
change	change, crisis, contingency, changing
remember	remembrance, remembering, recall, remember, reminder, remembered, recollection
last	lifetime, life, lifespan, longevity
too	time, this
eat	event, emergency, eating, end, eat
have	having, have, had, has
listen	listen, listening, listener, listens
pay	payment, payday, price, payoff, pay
miss	miss, mistake, missing, missed, misses
understand	understanding, understood, understand
retire	retirement, retire, recession, retiring, retired
suffer	suffering
see	seeing, sighting, see, sight, saw, sign, seen
talk	talk, time, talking, this
recover	recovery, remission, recover, recovering, restoration
starve	starvation, shutdown, starving
learn	learning, lesson, literacy
say	statement, speech, saying, say, said
wait	wait, waiting, waits
stop	stop, shutdown, stopping, slowdown, stopped
scream	scream, screaming, shout, scare, screams, screamed
remain	
finish	finish, finishing
rise	rise, revolution, rising
break	break, breaking, breakdown, broken, broke
follow	future, following, follow
quit	quitting, quit
lie	lie, lying, liar, lies
disagree	disagreement, dispute, disagree, debate, dissent, disagreements
graduate	graduation, graduate, graduating, graduated
burn	burn, burning, blaze, burned, burns
end	end, ending, event, emergency, era, expiration, eternity
laugh	laugh, laughter, laughing
strike	strike, striking, strikes
smile	smile, smiling, smiles, such
hurt	hurt, hurting, hurts
call	call, crisis, calling
walk	walk, walking, walked
deliver	delivery, day, deadline, deliver, delivering, delivered
ask	ask, answer, asking, argument, asked
prevail	
stick	stick, sticking, stable, stability
sleep	sleep, shutdown, sleeping
apologize	apology, agreement, apologize, apologizing, acceptance, attribution, apologies
explain	explanation, example, event, end, equation, explain, explaining, explained
kill	kill, killing
perish	panic
write	writing, write
vomit	vomiting, vomit
speak	speech, sentence, statement, speaking, speak, spoken
fold	fold, folding, f, folds, folded, failure, fork
agree	agreement, agreed, argument, agree, accord, acceptance, agreeing, alliance, agrees
drown	drowning, disaster, day, death
suffice	surplus, sacrifice, solution, substitution, sufficient, suffice
care	care, caring, concern, crisis, cares
resign	resignation, retirement, resign, resigned
exist	event, end, existence, ending, epoch, eternity, exist
teach	teaching, teacher, test, teach, time, taught, this
never	never
testify	testimony, trial, testifying, testify, truth, testified
collapse	collapse, crisis, contingency, catastrophe, cliff, chaos, collapsing
vanish	vanishing, void, vanish
protest	protest, provocation, protesting, protests
decide	decision, deadline, day, date, deciding, decisive, decided
triumph	triumph
sing	song, singing, show, solo, sing, such
stand	stand, standing, strike, stands
rest	rest, resting
count	count, counting, counts
drink	drink, drinking, day, date, drunk
continue	continuation, closure, continuity, continuing, cessation
crash	crash, crisis, crashing, catastrophic
escape	escape, exit, escaping, emergency, evacuation, end, event, eviction, escapes
fight	fight, fighting
heal	healing, heal, healed
blink	blink, blinking, blindness
soon	soon
show	show, sign, sighting, shutdown, spectacle, showing
refuse	refusal, refuse, refusing, rejection, request, resistance, refused, refuses
choose	choice, conflict, choosing, choose
move	movement, move, motion, moment, moving
watch	watch, watching
shine	shine, star, show, success, shining, special
matter	moment, meaning
think	thought, think, thinker, thinking, time, this
now	now
emerge	event, end, explosion, emergence, eclipse
grow	growth, garden, growing, grow
visit	visit, visitor, visitation, visiting
play	party, play, playing, performance
fit	fit, fitting, fits, flexible
suck	suck, sucks
burst	bubble, burst, breach, bursting, breakout, breakdown, bleeding
notice	notice, noticing, noticed
fade	fading, fade
bleed	bleed, bleeding, blood
again	apocalypse, attack, accident, anniversary
share	sharing, share, shared
arrive	arrival, announcement, apocalypse, arriving, anticipation
anyway	accident, argument, apocalypse, attack
cave	cave, collapse, crisis, crack, catastrophe
weep	weeping, weep
rebel	rebellion, revolt, riot, revolution, rebel, resistance
bail	bail, bond, bailout, bankruptcy, breakdown, bailed
forget	forgetting, forget, forgotten, forgot
read	reading, read, reader
bolt	bolt, breach, breakout
retaliate	retaliation, riot, retaliate, response, reaction, retribution, revenge, retali
reply	response, reply, reaction, respond, responding, replies
crack	crack, cracking, cracked
rule	rule, ruling
resist	resistance, refusal, rebellion, resisting, resist
appear	appearance, announcement, apocalypse, arrival
appeal	appeal, argument, appealing, auction, attack, ad, appeals
disappoint	disappointment, disaster, disappointing, disappointed
me	
freeze	freeze, freezing, frost, frozen
pop	pop, popping, pops
sell	sale, sell, strike, selling, sales
shoot	shooting, shoot, shooter, scare
eventually	end, ending, event, eventual, eternity
pray	prayer, pray, praying, prayers, prayed
drive	day, driving, dui, drive
take	time, take, taking, this, that
land	landing, launch, land, landfall
complain	complaint, complaining, complain, complaints, complained, criticism, complains
thrive	transition
struggle	struggle, setback, slump, struggling, stress
start	start, startup, stop, starting
stink	stink, smell, start
turn	turn, turning, this, tipping, time, that
comply	compliance, comply, complying, cooperation, compliant, compromise, conformity
lead	lead, leadership, leading, leader, led
succumb	suicide, suffering
hope	hope, hopeful, hoping
ever	end, ending, eternity, event
expire	expiration, extension, end, emergency, event, expired, eternity, ending, expire
hit	hit, hitting
choke	choking, choke, cough, contraction, crisis, choked
persist	persistence, problem, period, persist, paradox, persistent
vote	vote, voting, veto
make	miracle, mistake, making, make, made
confess	confession, crime, confess, conscience, confessions
snap	snap, snapping, shutdown, situation, snapped, shattering
evolve	evolution, epoch, event, end, experiment, ending, evolve
match	match, matching, mismatch, matches, matched
approve	approval, agreement, approving, approve, acceptance, affirmative, approved, authorization
give	giving, give, gift, given, good, gives, gave
melt	melt, melting, meltdown, melted
endure	end, eternity, ending, enduring, endurance, event
marry	marriage, marry
crumble	collapse, catastrophe, crisis, crack, crumble, chaos
decline	decline, death, depression, decay, deflation
always	always, absolute
publish	publication, prediction, publishing, publish
serve	service, serving, serve, served
manage	managing, management, managed, manage
tweet	tweet, tease, twitter, timeline, tweeting, teaser, typo, this, tweeted, tweets
close	closure, close, closing
march	march, marching, month, marches, mobilization
though	this, that, true, time, though
hear	hearing, hear
someday	someday, something, success
react	reaction, response, riot, react, reacting
sign	sign, signature, signing, signed, signs
look	look, looking, looks
kiss	kiss, kissing, kissed, kisses
intervene	intervention, intervene, incident, intervening, it, interference, intervened
ride	ride, rally, rider, riding, rides
perform	performance, party, performing, perform, performances
obey	obedience, order, obey, obligation, obedient, object, obe
hold	hold, holding, holds, held
settle	settlement, settling, settle, settled
revolt	revolt, rebellion, revolution, riot, resistance
drop	drop, dropping, day, dropped, drops
join	joining, join
slip	slip, slipping, slipped, slips
attack	attack, assault, ambush, attacker, aggression, attacking, attacked
believe	belief, believing, believe, believed, believer
travel	travel, trip, time, traveling, this, transit, that
attend	assembly, attendance, attending, appearance, announcement, audience, attend
sink	sinking, sink, storm
improve	improvement, innovation, improving, increase, it, improvements
argue	argument, arguing, argue, arguments, altercation, argued
guess	guess, guessing, guesses, guessed
reconsider	
cook	cook, cooking, celebration, cooked
please	please, pleasure, pleasing, party
worry	worry, worrying, warning, worried
object	object, objection, objects
qualify	qualifying, qualification, qualify
post	post, posting, promise, posted
judge	judgment, judge, judging, judgement, judged, justice
volunteer	volunteering, volunteer, voluntary, volunteered
erupt	eruption, explosion, explosive, emergency, event, earthquake, erupt
mourn	mourning, mourn
next	next, now
relapse	relapse, remission, recovery
rock	rock, rocking
faint	faint, famine, fever
cooperate	cooperation, cooperative, compromise, cooperate, cooperating, collaboration, cooper, concession, coordination
nap	nap, night
propose	proposal, propose, proposing, plan, proposed, provocation, prediction, presentation, proposes
get	good, gift
convert	conversion, convert, converting, conversions, converted, change, christian, converts
yield	yield, yielding
benefit	benefit, benefits
regret	regret, regrets, remorse, regretted
act	act, action, attack, acting
fry	fry, frying, fried, flood, failure
pee	pee, poop, problem, poo
flee	fleeing, flee, flight
comment	comment, commenting, comments, commentary, commented
flip	flip, flipping, flipped, flips
confirm	confirmation, confirming, confirm, confirmed, certainty, consensus
ship	ship, shipping, shipment
bloom	bloom, birthday, beauty
mind	mind, mindfulness
adapt	adaptation, adapt, adjustment, adaptive, adapting
yet	
fire	fireball, fire, fuse, firing
dance	dance, dancing
compete	competition, contest, championship, challenge, competitive
shout	shout, shouting, scream, shouts, screaming
report	report, reporting, reported, reports
wonder	wonder, wondering, wondered
bomb	bomb, bombing
pull	pull, pulling, push, pulled, pulls
bounce	bounce, bump, ball, bouncing, bounces, bounced
save	saving, save, saved, savings, success, saves
dominate	dominance, domination, dominant, dominating, dominate
buy	buy, buying
blow	bomb, blow, blackout
belong	belonging, belong, belongs
hang	hanging, hang, hung, holiday, hangs, hanged
accept	acceptance, agreement, accepting, accept, argument, accepted
sting	sting, strike
shrink	shrinking, shrink, shutdown, slowdown, size
slide	slide, slip, sliding, slipping
participate	participation, party, participating, participate, participant, protest, pledge, plan
meet	meeting, meet, match, met
spread	spread, spreading, scare
you	
jump	jump, jumping, jumper, jumps
insist	insistence, injunction, insist, insisting, it
leak	leak, leaking, leakage, leaks, leaked
rot	rot, rotation, rotting
rebuild	rebuild, recovery, rebuilding, restoration, reconstruction, repair, reboot, resilience
check	check, checking, checkpoint, checked, checks
occur	occasion
cease	cease, cessation
apply	argument, application
panic	panic
keep	keeping, keep
find	find, finding, found
pick	pick, picking, picked, pickup
bark	bark, barking
tomorrow	tomorrow, time, today
today	today, tomorrow, time
connect	connection, connect, connecting, coincidence, connector, click, communication, connectivity, connected, connections
linger	lingering, linger
hesitate	hesitation, halt, halting, hesitate
admit	admission, apology, agreement, admitting, admit, admitted, acknowledgement
surrender	surrender, surrendered, submission
smoke	smoke, smoking
arise	apocalypse, appearance, argument, arising, arise
tonight	time, tomorrow, today, this, that
indeed	impossibility, instance, intention, it
feast	feast, famine, festival, fasting
bitch	bitch, boycott, bitterness
release	release, releasing, releases, released
bake	bake, baking, birthday, baked, breakfast, bread
pitch	pitch, performance, promotion, pitching
prosper	prediction, prosperity
swear	swearing, swear, spit, slur, sign, spitting, swore
blog	blog, blogging, blogger, blogs
contribute	contribution, contributing, contributions, contribute, collaboration, contributor
yell	yell, yelling, yelled
promise	promise, prediction, pledge, prophecy, promised, promising, promises
sit	sitting, sit, seat, seating, seated, sat, sits, standing
shave	shave, shaving, shaved
adjust	adjustment, adaptation, adjust, adjusting
fuck	fuck, fucking, f, fucked
shatter	shattering, shatter, shattered
Die	death, day, dying, die, deadline, doomsday, dead
dream	dream, dreaming, day, dreams, dreamed
execute	execution, execute, event, executing, exploit, executed
elaborate	elaborate, explanation, event, example
right	right
out	out, outage
behave	behavior, behaviour
maybe	miracle, maybe
destroy	destruction, disaster, destructive, destroyed, destroy, demolition, damage, devastation
swallow	swallow, swallowing, swallowed
rain	rain, rainfall, rainbow
test	test, testing, tests, tested, this
knock	knock, knocking, knocks, knocked
rally	rally, riot, rallying, rebellion, reaction
regress	regression, regress, recession
prove	proof, prediction, prove, proving, proven, proved
buckle	buckle, belt, breakdown
suit	suit, style
hide	hiding, hide, hidden, hid
then	time, then, this, tomorrow, that
study	study, semester, studying, success
swim	swim, swimming, stroke
inherit	inheritance, inherit, it, inherited
reign	revolution, rebellion, reign
regenerate	regeneration, resurrection, rebirth, recovery, reboot, regenerate
retweet	retweet, rt
clarify	clarification, clarity, clarify, clear, comma, clarified, confusion, context
cross	crossing, cross, conflict, collision, confrontation, crossed
submit	submission, submitting, submit, submitted, submissions
beg	begging, bribe, bargain, beg, bribery, bargaining
need	need, needed, needs
whine	whine, whining
relent	refusal, resistance, relent
donate	donation, donating, donate, day
later	life
exit	exit, end, escape, event, evacuation, ending, eviction, exiting, exits
draw	drawing, draw, day, drew, draws, drawn
investigate	investigation, investigate, incident, investigating, inquiry, it
click	click, connection, clicking, clicked, clicks
himself	hour
beat	beat, beating
celebrate	celebration, celebrating, celebrations, celebrate, celebrated
surprise	surprise, shock, surprising, surprised, surprises
depart	departure, deadline, death, day
wake	wake, waking, warning, woke
spill	spill, spilling, situation, spills, spilled
soar	success, soaring
cheat	cheating, cheat, cheated
point	point, pointing, pointer, pointed, points
open	opening, open
cope	crisis, coping, contingency, cope
wander	wandering, wander, wake, week, wandered
probably	probably, probability, prediction, probable
begin	beginning, begin
repeat	repeat, repetition, repeating, repeats, repeated
kick	kick, kicking, kicked, kicks, kicker
freak	freak, fear
tire	tire, this, that, time
enter	entry, event, enter, entrance, entering, exit, end, election, entered, enters
forever	forever, future
stumble	stumble, stumbling, setback, slip
translate	translation, translator, translating, translate, translated, translations
battle	battle, brawl, battles
feel	feeling, feel, fear
also	attack, accident, apocalypse
concede	concession, concede, compromise, conceded, ceasefire, concedes
split	split, splitting, separation
cure	cure, curing, crisis, cured, cures
surface	surprise, something
catch	catch, catching, caught, catches, capture
coach	coach, coaching, championship
climb	climb, climbing
back	back
date	date, day, decade, deadline, dating, dat, due
register	register, registration, registering, record, registered
want	want, wish, wants, wanted, wanting
poop	poop, poo, period, problem
pause	pause, paused, pauses
enlist	event, enlist, election, emergency, engagement
switch	switch, shift, switching, shutdown
plead	plea, pleading, plead, provocation, pleaded
either	event, end, ending, election, emergency, explosion
cover	cover, covering, coverage, covered, covers
spring	spring, springs
hate	hate, hatred, hating, hated, hostility, hates
toast	toast, this, that
race	race, riot, rally, racing
repent	repentance, repent, redemption, resolution, remorse
experiment	experiment, experimentation, experimental, event, example, experimenting, explosion, experiments
form	formation, forming, future, form, fusion
kid	kid
balk	balk, breach
develop	day, development
merge	merge, merger, merging, merged
still	stable, stop, still, shutdown, stopping, spring
Fall	fall, falling, flood, failure, falls
score	score, scoring, success
inspire	inspiration, inspire, idea, inspiring, inspired, impact, inspirational, influence, inspires, it
question	question, questioning, questioned
feed	feeding, feed, feast, famine, flood, food, fed
clean	clean, cleaning, cleanup, cleaner, cleansing, cleans
excel	example, event, exceptional, excellence
snow	storm, snow
jail	jail
account	account, accounting, accident
rejoice	rejoice
apologise	apology, apologise, agreement, acceptance, acknowledgement, apologizing, apologies
rebound	rebound, recovery, relapse, reaction, reboot, resilience, restoration, recovering, recover
rap	rap, rave, record, rapper
recognize	recognition, recognizing, recognize, recognized
err	error, err, emergency, exception, example, event, execution
roar	roar, roaring, riot
correct	correction, correct, correctness, correcting, corrections
shift	shift, switch, shifting
commit	commit, commitment, committing, crime, crisis, committed, commits
blame	blame, blaming, blamed
here	hour, happen
become	birthday, becoming
shut	shutdown, shut, shutting, shutter, silence
recall	recall, recollection, recalled, recalling, remembering, remembrance, reminder, remember, recalls
trip	trip, this, that
ascend	ascent, apocalypse, ascend
rank	ranking, rank, rating, rankings, ranked
I	it
wear	wedding, wear, week, wearing
roll	roll, rolling, rolled, rolls
love	love, loving
nod	nod, nodding, nods, nodded
flourish	flourish, festival, flourishing, flowering
figure	figure
transform	transformation, transition, transform, transforming, transformative
died	death, dying, day, die, disaster, died, dead
steal	steal, stealing, stolen
launch	launch, launching
refrain	refrain, restraint, refusal
flood	flood, flooding, floods
death	death, die, day, dying
interfere	interruption, interference, interrupt, injunction, intrusion, interfering, interfere, it
bed	birthday
attest	argument, attack, agreement, accident, act
shrug	shrug, shrugged
expand	expansion, exponential, expand, expanding, extension, event, expectation, explosion, expansions
breathe	breathing, breath, breathe
float	float, floating, flood, fall, falling, floats
cut	cut, cutting, cutter, cuts
wink	wink
conform	conformity, conform, compliance, convention, compromise, change, consistency
first	first, fast
star	star, success, show
disperse	disperse, disturbance, disruption, dispersed, displacement, dissolution, disappearance
ruin	ruin
produce	production, prediction, produce, producing, productivity
demonstrate	demonstration, demonstrate, demonstrating, demo, demonstrated, display, demonstrations, demonstrates
cancel	cancellation, cancel, contingency, canceled, cancelled, crisis, cance
swing	swing, swinging, strike, swung, swings, switch
him	hour, he
terminate	termination, terminate, transition, terminating, terminated, termin, this
result	result
dissolve	dissolution, dissolve, disruption, dissolved, decay
smell	smell, scent, stink, sniff, smelling, smells
note	note, noting, notice, notation, notes, noticing
identify	identifier, identification, identify, identity, identifying, incident, instance, it
bet	bet, betting, bets
preach	preaching, prophecy, preach
ring	ring, ringing, rings
edit	edit, editing, error, editor, event, edited, edits
wish	wish, wishes, wishing, wished, will
despair	despair, depression, death, day, distress
differ	difference, disagreement, deviation, day
like	like, liking, likes, liked, love
hunt	hunt, hunting, harvest, hunter, hunts
collect	collection, collecting, collect, collector, collected, collections, catch, collects
set	set, sunset, setting
spawn	spawn, spawning
cough	cough, coughing, cold, contraction, choking, cessation
finally	failure
awake	alarm, awakening, alert, awake
deploy	deployment, deploy, day, deploying, deployed
push	push, pushing, pull, pinch, pushed, pause, pushes
instead	it
glow	glow, glowing, green
plan	plan, planning, prediction, planned, preparation, plans
dead	death, dead, day, die, dying
joke	joke, joking, jokes
mean	month, moment, meaning
bond	bond, bonding, bonded, bind, binding, bonds
forgive	forgiveness, forgiving, forgive, forgiven
us	
camp	camping, camp, curfew
well	well, win
Tweet	tweet, twitter, tweeting, tease, typo, timeline, trend, this, today, that
claim	claim, claiming, claims, claimed, contest
haunt	haunt, haunting, hour, halloween, haunted
use	use, usage, used, using
only	
resonate	resonance, response, reaction, resonate
direct	direct, directing, direction, directed, directive, director, directs
shop	shop, sale, shopping
actually	act, actual, action, actually
grin	grin, grinning, gag
leap	leap, leaping, launch, leaps
focus	focus, focusing, focused
state	statement, speech, state, stating, stated
mine	mine, mining
loose	loss, leak, loose
command	command, commands, commanding, crisis, call, commanded, control
prison	
really	revolution
age	age, anniversary, aging, average
in	in, incident, it
reveal	reveal, revelation, revealing, release, revealed
cheer	cheer, celebration, cheering, cheers, cheered
escalate	escalation, emergency, event, eruption, escalate, escalating
enroll	event, enrollment, election, enroll, engagement
wreck	wreck
provide	providing, provide, promise, provided
witness	witness, witnessing, witnesses, witnessed, watch
print	print, printing, printer, publication, paper, printed
prosecute	prosecution, prosecute, prosecuting, prosecuted
touch	touch, touching, touched, tap, this, tactile, that, touches
overdose	overdose, od, opioid
blush	blush
will	will, win, won
send	sms, sending, send
revert	revert, reversal, reset, reverted
withdraw	withdrawal, withdraw, withdrawing, withdrawn
carry	carrying, carry, carried, contingency, carries
default	default, defaults
train	training, train, test, timetable, this, trained, time, that
bend	bend, bending, break, breaking, bent
practice	practice, practicing, promise, practiced, preparation, performance
slay	slaying, slay, slaughter, slain
whistle	whistle, whist, whine
tie	tie, tying, tied, this, time
failed	failure, famine
sew	sewing, sew, seam, stitch
ski	ski, skiing, slope, summit, snow
subscribe	subscription, subscribe, subscribing
awaken	awakening, alarm, alert, awareness, awake, apocalypse, awaken
it	it
dare	dare, daring, dared, defiance
already	apocalypse, already, adaptation, advance
slow	slowdown, shutdown, slowing, stop, slow
debut	debut, day
tear	tear, tearing, tears, this
shortly	shutdown
interrupt	interruption, interrupt, interrupted, interrupts, it, interference
clash	clash, conflict, confrontation, crisis, collision, chaos
deal	deal, deadline, dealing, death
nurse	nursing, nurse
fragment	fragment, fragmentation, fracture, fragments, fracturing
better	better
build	build, block, building
child	catastrophe, crisis
one	one
soften	soften, shift, slowdown, shutdown, softened
fast	fast, flash
attempt	attempt, attack, attempted, abort, accident, attempting, attempts
punch	punch, punching, punched
power	power, prediction
overcome	obstacle, overcoming, outcome, overcome
sweep	sweep, sweeping, sweeps, swept
book	book
respawn	respawn, reboot, resurrection
curse	curse, cursing, curses, cursed
charge	charge, charging, charged
rip	rip, ripping, rupture, ripped
relate	relationship, relating, relation, relate
disarm	disarm, deadline, deterrence
whisper	whisper, whispering, warning, whispered, whistle, whispers
let	
transfer	transfer, transition, transferring, transaction, transfers, this, transmission, transit
increase	increase, inflation, increment, it, increasing
gain	gain
chuckle	chuckle, comedy
swell	swell, swelling, swollen, scaling
multiply	multiplication, multiplier, multiply, multiplying
pump	pump, pumping, pulse, pumps
murder	murder, massacre, murderer, murdering
morph	morph, mutation
part	parting, part
update	update, upgrade, updates, updating
left	
double	double, doubling, doubled, doubles
combust	combust, combustion, crisis, catastrophe
fracture	fracture, fracturing, fall
retreat	retreat, retreating, retreated
realize	realization, realizing, reality, recognition, realized, realize
dry	day, drought, drying, dry, drip, drop, dehydration
wave	wave, waving, waves, waved
spoil	spoil, spoiled, spoiler, stress
sweat	sweat, sweating, storm, sweats
relax	relaxation, relax, relaxing, relaxed, release, relief
text	text, texting, tweet, this, typo, termination, texts
bear	bear, birth, baby, birthday, bearing
reconcile	reconciliation, resolution, reconcile, relationship, resolve
swarm	swarm, storm, strike
collaborate	collaboration, collaborating, collaborate, collaborative, cooperation, coordination, collaborator, communication
reverse	reversal, reverse, reversing, reversed, reversible
cost	cost, crisis, contingency, cpi
block	block, blocking, blocker, break, blocks, blocked
black	black, blackout, breakout, blindness
thank	thank, thanking, thankful, thanks, thanked
declare	declaration, declare, declaring, declared, declares, declarations
own	ownership, owner, owning
experience	experience, event, eclipse, episode, experiencing, experienced
adopt	adoption, adopt, adopting, adaptation, announcement, acceptance, acquisition, adopted, adoptive
advance	advance, advancement, acceleration, achievement, argument
complete	completion, complete, closure
descend	descent, death, doom, descending, descend
function	function, failure, future, functional, functioning
step	step, stepping, stop, steps, stepped
announce	announcement, announce, announcing, announced, announcements
reload	reload, restart, reboot
add	add, addition, adding, additive, added, adds
skate	skate, skating, skip, speed
spike	spike, spikes, spiked
resolve	resolution, resolve, resolving, resolved
up	uprising, up
assist	assist, aid, assistance, aide, assisting, act
boy	
dies	death, dying, day, disaster, die
chill	chill, chilling, cold, calm
search	search, searching, searches, session, searched, success
offer	offer, offering, opportunity, option, opening, offered, offers
measure	measure, measurement, measuring, measured, moment, measurements, metric, measurable
spit	spit, spitting, spat, saliva, spill, swearing
profit	profit, profitability, profits, profitable
bow	bow, bows, bowed
eject	eject, expulsion, evacuation, exit, event, emergency, escape, ejected
shed	shedding, shed, separation
bust	bust, boom, bubble, break, breakdown, breaking, bursting
jam	jam, jammed, jams
corrupt	corruption, corrupt, corrupted, crisis
wipe	wipe, wiping, wipes, wiped
cringe	cringe
sigh	sigh
veto	veto, vote, vetoed, voting
scar	scar, surgery
plummet	plummet, plunge, panic
cycle	cycle, cycles, clock, cycling
scatter	scatter, scattering, storm, sprinkle, snowball, separation
wrestle	wrestling, wrestle
indict	indictment, impeachment, insurrection, injustice, it
hurry	hurry, hour, haste
disapprove	disapproval, dissent, disagreement, displeasure, disapprove
game	game, glitch, gaming, games, gameplay
fart	fart, feces
hire	hire, hiring, hour, hired, hires
compensate	compensation, compensate, contingency
assume	assumption, assumed, assume, assuming
signal	signal, signaling, sign, sos, signalling, signaled, signals
sacrifice	sacrifice, sacrificing, suicide, sacrifices, slaughter, sacrificed
suspect	suspect, suspicion, suspected, suspicious, scare
prepare	preparation, prepare, preparing, prep, prepared
stir	stir, stirring, spring, storm
relocate	relocation, relocate
roast	roast, roasted, riot
lapse	lapse
free	freedom, free, freeing, freed
somehow	success, situation, snowball, something
topple	tornado
tour	tour, touring, tours, this
offend	offence, offense, outrage, offensive, offend, offended, outburst, offending
sail	sail, sailing, storm, sails, separation
hatch	hatch
rant	rant, rage, riot
fish	fish, fishing, flood, fry
proceed	plan, proceeding, progress
dig	dig, digging, drill, dump, day, dug, drilling
crater	crater, crash, catastrophe
wash	wash, washing, week
light	led, light, lightning, lighting
shit	shit, situation, stink
throw	throw, throwing, toss, thrown, throws, threw, this, tossing
boom	boom, bang, bubble, bell
upload	upload, update, uploading
reform	reform, revolution, revolt, reforming, reforms
divine	death, divine
mend	mend, miracle
satisfy	satisfied, satisfaction, satisfying, satisfy, satisfies
predict	prediction, predictor, predict, predicting, predicted, predictions, probability, prophecy, predictive
myself	
convict	conviction, convict, crime, convicted
litter	litter
progress	progress, plan
RIP	rip
more	miracle, more
discover	discovery, discovering, day, discover, discovered
boot	boot, bug
design	design, designer, day, designing
divide	divide, division, dividing, divergence, deficit, distribution
herself	hour
police	provocation, protest, prevention, police
vent	vent
okay	okay, ok
rupture	rupture
rage	rage, riot, revolution, revolt
capture	capture, capturing, captures, catch, captured
shudder	shudder, shaking, scare, shake, shock
reach	reach, reaching, release
fix	fix, fixing, failure, fixed, fixes
bless	blessing, bless, blessed, blessings
box	box, boxing
handle	handle, handling
conquer	conquest, conquering, conquer, conflict
after	apocalypse, attack, accident
court	conflict, court
control	control, controlling, crisis, controlled, chaos
shove	shove, snowball, squeeze, slide
likely	likely, likelihood
rape	rape, rapist, riot, raping, raped
stall	stall, shutdown, slowdown, stop
list	list, listing, lists, listed
if	if, it
hail	hour, hail, hurricane
scale	scaling, scale, shutdown, shift
paint	painting, paint, painter, project, painted
lay	laying, lay, laid, lie, lying, lays
balloon	balloon, bubble, boom, burst, bleed, birthday, bursting, balloons
unravel	
mate	mating, match, mate, marriage
fill	fill, filling, fills, filled
rent	rent, rental, renting
vary	variable, variation, variability, vary, volatility
enjoy	enjoyment, event, enjoy, enjoyable, eclipse, enjoyed, enjoying, entertainment
fine	fine, failure, fault
doubt	doubt, denial, death
cop	cop, crime, coup
referee	referee
betray	betrayal, betray, betrayed, breach
host	hosting, host, hosts, hospitality, hosted
scan	scan, scanning, scanner, scans, scanned, screen
embrace	embrace, embracing, event
home	hour, home, holiday
protect	protection, protecting, protect, protector, protected, protective
overlap	overlap, overlapping
dawn	dawn, day, daylight
good	good, great
Win	war, win
decay	decay, disaster, death
that	that, this
reboot	reboot, restart, reset
boast	boast, boasting, bragging
crawl	crawl, crawling, catastrophe, crawled
man	
receive	receiving, receive, receipt, received
conclude	closure, conclusion, completion
resume	restart, resume, reboot, restoration, recovery, restoring
put	put, putting, puts
blind	blind, blindness, blinding, blinded, blackout
resurrect	resurrection, rebirth, revival, reboot, resurrect
flow	flow, flood, flows, flowing, fountain, fluid, flowed
farm	farm, famine, farming, flood, farmer, fertility
defend	defense, defending, defend, defence, defended, defensive
all	apocalypse, accident, attack
trump	trump, triumph
her	hour
he	hour, he
reproduce	reproduction, reproduce, replication
riot	riot, riots, rebellion, revolution
press	press, push, pressing, pressed, pushing
skyrocket	spike, success
breed	breed, breeding
echo	echo, event, echoing, effect, echoes, echoed
so	shutdown, sunset, so
photograph	photograph, photography, photo, photographer, picture, portrait, photographic
face	face, facing
recoil	recoil, reaction, reflex, riot, response
bowl	bowl, bowling, boil, ball, bowls
arrest	arrest, attack, arresting, arrested, arrests
stare	stare, staring, silence, stared, stares
unite	unification, unity, union, unite
trust	trust, trusting, trustworthy, trusted, this
drift	drift, drifting, deadline
tread	tread, threat, this
gasp	gasp, gag
spell	spell, spelling, spelled, speech, something
beam	beam, blink, breach, beams, blinding, blinking
beware	
mobilize	mobilization, mobilize, mobilized
no	
bring	birthday
curl	curl, curve, curled, contraction, curls, chaos, curly
fuse	fuse, fusion, fracture, fire
wins	win, winning, winner, wins, won
scoff	scoff
cum	cum, climax, condom, circumcision
clear	clear, clearing, clarity, closure, completion, clearance
trigger	trigger, triggering, threat, triggered, this, triggers
hike	hike, hiking, hour, holiday, hikes
hell	hour, hell
chip	chip, crack, chips, cybersecurity
verify	verification, verify, verifying, verified
shake	shake, shaking, shift, start, shaken, shudder, snap, shakes
once	
reason	reason, reasoning, rationality, rational
twitch	twitch, tick, trigger, this, that, triggering, time
applaud	applause, applaud, audible, audience, award, applauded, approval
operate	operation, outage, operating
solo	shutdown, strike, survival, suicide
self	shutdown, suicide
integrate	integration, integrate, integrating, interaction, integrated, implementation, it
perhaps	prediction, possibility, perhaps
teleport	teleport, teleportation, this, transition, time, transfer, that, transit
convince	convincing, convince, convinced
record	record, recording, release, recorded, records
sound	sound, s, scream, sounding, sounds
upgrade	upgrade, update, upgrading, upgrades
this	this, that, today
life	life
baby	birthday, baby
shower	shower, showers, saturday
wind	wind, week, weather, winds, winter
pack	pack, packing, purge, packed, packs, preparation
however	hour
tip	tipping, tip, tipped, tap, this, that
project	project, projection, phase, prediction, presentation, problem, projecting
anyways	attack, accident, apocalypse, argument
repay	repayment, repay, refund, repaid
sob	sob, scream, sad
reject	rejection, refusal, reject, rejecting, rejected, rejects, refusing, response, refuse, resistance
duck	duck, delay, dunk, dodge, dive, dash, ducks, diving
broadcast	broadcast, broadcasting, blackout
delay	delay, deadline, delaying, delayed, delays
inform	inform, informing, instance, informed, it, information
slice	slice, slicing, steak, slash, sliced, slices, slashing
communicate	communication, conversation, communicating, communicate, communications, communicated
copy	copy, copying, clone, copied
hand	hand, hour, handshake, handing
mature	maturity, milestone, mature
contend	crisis, conflict
wed	wedding, wed
stray	stray, separation, situation
dress	dress, day, dressing, date
observe	observation, observe, observing, observed, observer, observable, observes
peak	peak, period, plateau, performance, peaked
deny	denial, deny, denying, denied
compare	comparison, compare, comparing, competition, comparisons
storm	storm, shutdown
restore	restoration, restore, restoring, restored, recovery, repair, restitution
restart	restart, reboot, reset, recovery
charm	charm, charms, charming, compliment
stone	stone, shattering, stones
code	code, clock, coding
deflect	deflect, delay, defect, denial, deviation, deterrence
won	war
tumble	tumble, tornado, this
feature	feature
appreciate	appreciation, appreciated, appreciate, appreci, advance
time	time, timer, timing, this, timed
fare	failure, famine, fall, fair
else	event, end, emergency, execution, exception, election, evil
dictate	deadline, dictate, decision, default, domination, dominance
cause	cause, catastrophe, crisis, chaos, causation, caused
depend	dependence, default, depend, dependent, dependency
what	
fumble	fumble, fault, failure, fall
hover	hover, hovering
hug	hug, hugging, handshake, hugs, hello, hugged
harvest	harvest, harvesting, harvested
piss	piss, pee, period, poop
abort	abort, abortion, accident, alarm, aborted
space	shutdown, space, sunset
orbit	orbit, orbital, orbiting, orbits
brew	brew, brewing, boil, beer, brewery, boiling
supply	supply, shortage, surplus, supplying, supplier
rescue	rescue, rescuing, resc, rescued
compute	computation, compute, computing, clock, computed
on	outage, on
allow	agreement, allow, argument, allowed, allowing
frown	frown, frowned, face
rewrite	rewrite, rewriting, revolt, rebellion, revolution, revision
engage	engagement, engage, event, engaging, encounter, engaged
divorce	divorce, dissolution, decree
defeat	defeat, defeated, death
fear	fear, fearful
often	outburst, occurrence, often
impress	impress, impression, imp, impressed, it
yes	
OK	ok, okay
name	naming, name, named
delete	deletion, delete, deleting, day, death, deleted
strip	stripping, strip, stripped
both	both
boil	boil, boiling, boils, boiler, boiled
lift	lift, lifting, lifts, lifted
moan	moan, moaning, misery
summarize	summarize, summary, shutdown, statement, summarized, success, summarizes
weld	weld, welding
challenge	challenge, challenging, crisis, challenged, challenges
review	review, reviewing, reviewer, rating, receipt, reviews, reviewed
pretend	pretend, pretending, prank, pretended
down	death, disaster, drop, defeat, down
achieve	achievement, accomplishment, achieved, achieve, aim, achieving
request	request, requesting, requests, requested
long	lifetime, lifespan, life, longevity, long
thing	thing, this, that
succeeded	shutdown, strike
rush	rush, rushing, response
flock	flock, flood, famine, feast
homer	
by	
weigh	weight, weigh, week, weighing, weighed
defect	defect, death, default, defects
party	party, partying, parties
distract	distraction, distract, distracting, distracted, delay, diversion, distractions, disruption
cool	cool, cooler
recruit	recruit, recruiting, recruitment
sniff	sniff, smell, stink, scent, something, smelling
align	alignment, align, agreement, aligned
immediately	instantaneous, instant, immediate, immediately, instance, it
fret	fret
empty	empty, emptiness, end, event, exit, exception, ending, expiration
transition	transition, transitioning, transitions, transformation, timeline, time, transitional, termination
infect	infection, illness, infected, infect, invasion, it, infections, infectious
day	day, deadline, death, date
itch	itch, itching, infection, irritation, injury, it
forfeit	forfeit, forfeiture, forfe
sense	sense, sensing, signal, sensation, sign
evacuate	evacuation, emergency, event, earthquake, evac, eruption, evacuate, evacuated
top	top, topping, that, this
them	this, that
demand	demand, deadline, demanding, demands, demanded
pretty	progress
cap	crash, clock, cap, collapse
abide	agreement, abide, abiding
girl	
nest	nest, nesting
commute	commute, commuting
key	key, keys
BE	birthday
patrol	patrol, patrolling, protection
create	creation, creating, create, creator, crisis, cause, cycle, created, creativity, chaos
hopefully	hour
shock	shock, surprise, scare, shocked, shocks, shocking, shaking
seem	surprise, sighting, show, something, seeming
present	present, presentation, party, preview
capitalize	capitalize, comma
file	file, ftp, filing
guard	guard, guarding, guarded
am	apocalypse, attack
solve	solution, solve, solving, situation, solved, success
just	just
we	
head	head
breakdown	breakdown, break, breakup, breaking
drip	drip, drop, dripping, diarrhea, dehydration
off	off
discriminate	discrimination, discriminate, discriminating
accelerate	acceleration, accelerator, advance, accelerating, accelerate, attack, accelerated
chew	chew, chewing, crunch
invest	investment, ico, invest, ipo, investor, idea, investing, it
bullshit	bullshit, bluff
spend	spending, spend, spent
spin	spin, spinning, spins, spun
flash	flash, flashing, fireball, flashed
God	god
mount	mount, mounting, mountain, mounted, mounts
snowball	snowball, storm, shutdown, snow
jog	jog
compromise	compromise, concession, compromising, crisis, conflict, compromises
alone	attack, apocalypse, accident
Fail	failure
retract	retract, retracted, release
collide	collision, crash, collide, clash, catastrophe, concussion, convergence
foul	foul, fall, fou, fatal
freelance	freelance
wolf	wolf
guarantee	guarantee, guaranteed, guaranteeing, guarantees
repeal	repeal, referendum, revolution, recession, repealing
misunderstand	misunderstanding, mistake, misunderstand, misconception, misunderstood
taste	taste, tasting, time, test
address	address, attack, argument, announcement, answer, addressing
sway	sway, shift, swing
repair	repair, recovery, restoration, repairing, repairs, repaired
wrong	wrong
campaign	campaign, campaigning, coup, campaigns, crowdfunding
to	this, that, time, to
anchor	anchor, anchors, attack, avalanche, anchored
venture	victory
definitely	death, deadline, day
renew	renewal, renew, renewed
download	download, downloading, day, delay, downloads, downloaded
even	event, end, equality, equal
derail	disaster, disruption, derail, derailed
vacuum	vacuum
answers	attack, argument, accident
contract	contract, contraction, contracting, contracted, contracts
phone	phone
rethink	revolution
unfold	unfolding
bike	bike, bicycle, biking, birthday
chat	chat, conversation, chatting, call, chatter
steer	steer, steering
coin	coin, cycle, cryptocurrency, century, coins, cash, currency
recharge	recharge
two	two
abound	apocalypse, attack
manifest	manifestation, manifest, moment
worsen	worsening
piece	piece, puzzle
school	shutdown, survival
reopen	reopen, restoration, recovery
enough	event, end, emergency, earthquake, execution, eclipse
Posted	
DJ	dj, djs
migrate	migration, move, migrating, migrate
way	
torture	torture, threat, tort, this
invite	invite, invitation, inviting, invited, invites, invitations, it
crest	crash, celebration, crest
define	definition, defining, defined, define, day, defines, declaration, deadline
WIN	win, winning, winner, war, wins, won
disband	dissolution, disband, disruption
surely	strike, shutdown, success
survived	survival
license	license, licensing, licensee, licence, licenses, licensed
there	there, time, that, this
year	
pale	
OD	
advise	advise, advice, advising, advisory, argument, adviser, advisor, advised
Survive	shutdown, strike
consider	consideration, consider, considering, conversation, considered
type	type, typo, typing, typed, this, timeout, that
separate	separation, split, separating, secession, splitting, separate
skip	skip, skipping, skipped, sprint
drag	drag, dragging, delay, deadline, dragged, day
spot	spotting, sighting, spot
sunset	sunset, shutdown, storm, strike
most	
reside	residence, residency, relocation
expect	expectation, expect, expected, event, expectations, expects, estimate, expecting
college	crisis, catastrophe
order	order, ordering, orderly, ordered, orders
lock	lock, locking, lockdown, lockout, locked, locks
rear	rear, rally, retaliation
quote	quote, quotation, quoting, quotes, quotations, quoted
interview	interview, interviewer, interviews, interviewing, it
away	apocalypse, accident, attack
son	shutdown, strike
bald	
might	
stitch	stitch, stitching, stitches, sock, sewing
stump	stump, shutdown, strike, skeleton
course	crisis, catastrophe, consequence, contingency
over	outage, over
Cry	crisis, catastrophe
she	shutdown, strike, survival, surviving
grace	
swoop	swoop, strike, sting, stealth
support	support, supporting, supported, supports, supporter, supportive, shutdown, solidarity
lecture	lecture, lecturer, lesson, lectures, lect
debate	debate, disagreement, dispute, discussion, debating, discourse, debates, dissent
reap	reap
themselves	this
stew	stew, shutdown, storm
trade	trade, trading, transaction, this, today
known	
dot	dot, dots, day, delay, dotted, death
malfunction	malfunction, meltdown
lack	lack, loss, lacking
avail	attack, accident, apocalypse
yawn	yawn
consent	consent, contract, consensual, cooperation, coercion
brawl	brawl, battle, bang
reflect	reflection, reflecting, reflect, reflected, reaction, result, reflective, reflects
pursue	pursuit, plan, pursuing, pursue
proof	prediction
speed	speed, speeding, slowdown, sprint
place	place, party, placing, placement
sketch	sketch, sketches
quickly	quick, quickly
plot	plot, plotting, prediction, plan, plotted, planning, plots
trick	trick, trap, tricks, this, tricked
invade	invasion, intrusion, intruder, invading, invade, invaded, it
gamble	gamble, gambling, game, gaming
determine	decision, deadline, determination, day, determining, determined, determine
coast	catastrophe, crisis, collapse
latch	latch, lock, locking
gel	gel, glitch, growth, glue
stroke	stroke, strokes
opt	opt, option, outcome, opting
brain	blackout
eclipse	eclipse, event, eclips, emergency, eruption
sour	sour, storm, shutdown
badly	
perfect	perfection, perfect, performance
loot	loot, looting, loss, looted
mix	mix, mixing, mixture, mixer, magic
shovel	shovel, shutdown, storm, snow, shift, snowball
parent	parent, parenting, period, parental
elect	election, emergency, eclipse, event, elections, electing
zero	zero
rocket	rocket, revolution, rally
filibuster	filibuster
shred	shred, shredded, shutdown, shattering
expose	expose, exposure, exposing, exposed, explosion, event, earthquake, exposes
reconnect	reunion, reconnect, relationship, reconciliation, restoration, reboot, reset
nail	nail, nails, nailed
s	shutdown, strike, success
ignite	ignition, ignite, incident, ignited, it
mail	mail, mailing, month
dispute	dispute, disagreement, disputes, disputed, dissent
circulate	circulation, circulating, crisis, circulated, circulate
dust	dust, day, disruption, dirt
size	size, sizing, shrinking, scaling, swelling
mushroom	mushroom, mushrooms
dwell	death, day, delay, dwelling, dwell
Skype	skype, session, such
sprint	sprint
grate	grace, grate
override	override, overriding, outcome, option, overload
white	
fib	fib, fraud, fallacy, fracture, false
mother	
crow	crow, celebration, coup
weather	weather, winter, warning
harm	harm
reward	reward, rewards, rewarded, rewarding
a	a, accident, attack, apocalypse, an
spew	spew, spill, spitting, spit
revive	resurrection, revival, rebirth, reboot, restart, recovery, regeneration, restoration
replace	replacement, replace, replacing, retirement, replaced
punt	punt, penalty, pun, punishment
blast	blast, bomb, bang, burst, boom
Live	
scroll	scroll, scrolling, shutdown
provoke	provocation, provoke, provoking, provoked
represent	representation, represent
slam	slam, slamming, slams, smash, slammed, smashing
alert	alert, alarm, attack, audible, alerts
email	email, event, emergency, example, error
red	red, rainbow, riot
stack	stack, stacking, stacks, snowball
spar	spar, showdown
fulfill	fulfillment, fulfilled, fulfilling
desert	desert, death, drought, disappearance
pin	pin, pinned, pins, prank, pinch
father	flood, failure, famine
track	track, tracking, tracker, trace, time, trail, tracked, this, tracing, tracks
job	
ensure	emergency, event, end, earthquake, ending
innovate	innovation, invention, idea, it, innovative
late	loss
flag	flag, failure, flags
sober	shutdown, sober
zip	zip, zipper
fuel	fuel, fuse, fire, failure, fueling
heat	heat, heating, hot, hurricane
acknowledge	acknowledgement, acknowledgment, acknowledge, acknowledging, acceptance, agreement, acknowledged, affirmation, accepting
troll	troll, trolling, trolls, tweet, threat, taunt, this, that
heart	hour, holiday, heart, happiness
gather	gathering, gather, gathers, gatherings
negotiate	negotiation, negotiating, negotiate, negotiations
gold	gold, golden
maintain	maintenance, maintain, maintaining
tattoo	tattoo, this, tattoos, that
revise	revision, revise, revolution
brake	brake, braking, brakes
activate	activation, alert, attack, activate, action
parachute	parachute
second	
lost	loss, lost, losing, lose
sample	sample, sampling, stimulus, samples, specimen, sampled
ultimately	
surf	surf, surfing, sunset, storm, spawning
sometimes	shutdown, setback, sometimes, something
exercise	exercise, event, exercising, example
easily	example, escape, end, execution, earthquake, error, equality
honor	honor, honoring, honour, honored, holiday, honors
Sunday	shutdown, strike
include	include, inclusion, item, infinity, included, it, inclusive, includes, including
tackle	tackle, tackling, touchdown, tackled, this, tackles, that
cruise	celebration, cruise, carnival, crash
sir	shutdown, strike
single	shutdown, strike
at	attack, accident, apocalypse
Be	birthday
ID	id, identification, identity, identifier, incident, it
ready	
blank	blank, block, blocking
redirect	redirect, redirected, restart, retweet, routing
yellow	yellow
none	
earn	earn, earned, earning, event, earnings
illustrate	illustration, illustrating, illustrate, illustrated, it, illustrates
recommend	recommendation, recommend, recommending
inevitably	inevitable, impossibility, inevitably, it
converge	convergence, converge, collision, coordination, coordinate
dive	dive, diving, dip, drop, dunk, dove, drowning, dives, death
wit	warning
soul	shutdown, strike
rake	rake, ra
sag	sag, shattering
approach	attack, approach, approaching, advance, appearance, abduction, aggression
influence	influence, impact, influencing, intention, influential, it
Miss	
park	park, parking, period
trace	trace, tracing, trail, traced, track, traces, tracking, time, this, that
ha	hour
await	apocalypse, anticipation, attack, announcement
jar	jar
gone	
document	document, documentation, declaration, documenting, day, documentary, date, documented
grab	grab, grabbing, grabs, grasp, grapple, grabbed, grasping
partake	party, participation, protest, partake, participating
disconnect	disconnect, disruption, disconnected
literally	literally
flirt	flirt
surpass	success
guide	
Wed	warning
delegate	delegate, delegation, delegated, default, disagreement, delegates
deserve	deserve, deserving, deserved, deserves, due
commence	commencement, countdown, ceremony, construction
Google	google
entertain	entertain, entertaining, event, entertainment, episode
wanna	warning
cast	cast, casting, casts, curse
accomplish	accomplishment, achievement, achieved, achieve, achieving
persuade	persuasion, persuade, persuasive, persuaded
chant	chant, chanting, celebration, chants, chanted
govern	government, govern, governing, governance
diminish	death, decline, day, decrease, diminishing, decay
unveil	unveiling, unveil
bottle	bottle, breach, blackout, breakdown
interpret	interpretation, interpret, interpreter, interpreting, interpreted, it
sustain	sustain, sustaining, survival, sustained, surviving, survive
draft	draft, drafting, drafts, declaration, day, delay
educate	education, event, educate, educator, educational, example, educating, election, enlightenment
counter	counter, countering, counters, countered
bind	bind, binding, bound, bond, binds, bonding, bindings
warn	warning, warn, warnings, warned
narrow	narrowing, narrow
explore	exploration, experiment, explosion, event, exploring, explore, encounter, exhibit, experimentation, experimenting
calculate	calculation, calculator, computation, clock, calculating, calculate, calculated
premiere	premiere, premier, preview
seize	seizing, seizure, seize, situation, shutdown, stop, seized, seizures
flame	fire, flame, fireball, fuse, flaming
drone	drone, day, drones
bat	batter, batting, bp
recite	recite
sooner	shutdown, strike
fruit	fruit, festival, feast, failure, fruits, flowering
night	
bluff	bluff
bob	bob, bounce, boom
gag	gag
war	war, wartime, warfare, wars
hint	hint, hints
tick	tick, ticking, time, trigger, this, ticks, triggering, timing
creep	creep, creeping, creepy, creeps
detect	detection, detect, detecting, detector, detected
consume	consumption, consuming, consume, consumed
amend	amendment, amend, amended, alteration, article, agreement, anarchy, amendments
disclose	disclosure, disclosing, declaration, disclosed, disclose, disclosures
detail	detail, delay, day, death
bother	bother
stress	stress, stressed, situation, stressing, stressful
LIVE	life, live
flush	flush, flood, failure, flushed, flooding
dim	dim, death, darkness, delay, day, dusk, daylight
conflict	conflict, crisis, contradiction, clash, contingency, conflicts, chaos
rat	rat, riot, rebellion, revolt, reaction, rats, retaliation
lol	
imagine	imagine, idea, imagining, imagination, illusion, it
organize	organization, organizing, organize, organizer, organized, order
bid	bid, bidding, bidder, bet, bids
ghost	ghost, ghosts
cancer	cancer, catastrophe, crisis
ice	ice, instance, icing, it
Blink	
rescind	
recycle	recycling, recycle, reuse, recycled
erase	erase, event, eclipse, extinction, erased, earthquake
permanently	
brother	
avoid	avoidance, avoid, accident, attack, avoiding, annoyance, avoided
bill	bill, balance, billing, billed
dock	dock, docking, delay, discharge, day, displacement
remove	removal, removing, remove, removed, removes
NOT	not
sort	sort, sorting, sorted, shutdown, sorts
suicide	suicide, suicidal
roam	roaming, roam, riot
concentrate	concentration, concentrate, concentrating, clarity
Saturday	shutdown, strike
bankrupt	bankruptcy, breakdown, bankrupt
climax	climax, culmination, confrontation, conflict, crisis, closure
yesterday	
knit	knit, knitting
stabilize	stabilization, stability, stable, stabilize, shutdown, stabilized
coincide	coincidence, convergence, coincide, conjunction
load	load, launch, loading
labor	labor, labour
soldier	shutdown, strike, survival
conceive	conception, child, cycle, conceived, conceive
truth	threat, time, this
trumpet	trumpet, this, that
contest	contest, challenge, contested, competition, contests
purge	purge
Pass	
ya	
cake	catastrophe, crisis
revenge	revenge, retaliation, retribution, revolution, riot
screw	screw, screwed
bump	bump, bounce, bang, boom, bumps, bumped
absorb	absorption, absorb, absorbing, acquisition, adaptation, attack, acceptance, absorbed
upset	upset, upheaval, upsetting
truck	tornado, truck, that, this, tipping, theft
spare	sacrifice, sunset, shutdown, spare, saving
aid	aid, assist, assistance, aide, ally, aiding, assisting
reset	reset, reboot
warm	warmth, warm, warming, winter
raise	raise, rise, rally, raising, rising
worship	worship
rather	riot, revolution
stalk	stalking, stalk, sighting
spiral	spiral, snowball
lives	life
fal	failure
decipher	decoding, decipher
criticize	criticism, critique, critic, complaint, criticizing, critical, criticize
defer	delay, defer, deferred, deadline, delaying, default, delayed
disembark	departure, delay, docking
thin	thin, time, this
color	color, change, coloring, colour, cycle
salute	salute, signal, such
ad	attack, apocalypse
shot	shooting, shot, shoot, shootout
retrieve	retrieval, retrieve, retrieving, recall, response, receipt, recovery
don	day, deadline, death
fat	fat, fatty, f
flower	flower, festival, flowering, fertility
delight	delight, delighted
frost	frost, freeze, freezing, fall
weaken	weakening, weakness, weaken, weak
slot	shutdown, sunset
juice	juice
boycott	boycott, blockade, boycot, bds
grave	grave
sneak	sneak, sneaking, slip, stealth, steal, stealing, something
twist	twist, turn, twisting, this, twisted, twists, time
STOP	stop, shutdown, stopping, slowdown, stopped
waiver	waiver
scrape	scrape, scraping, scratch, scrap, spill, strike, sliding
another	attack, adaptation, apocalypse
best	best
some	shutdown
otherwise	
intercept	intercept, interception, intercepted, interrupt, interruption, interference, it
quake	quake
spy	spy, spying, surveillance
sub	sacrifice
specialize	specialization, specializing, success, specialize, special, surplus, specialty
why	
surge	surge, spike, surges, shutdown, surging
Sue	shutdown, strike
breach	breach, break, breakdown, breaching, breached, breakout, breaking
welcome	welcome, welcoming, welcomed, welcomes
impact	impact, incident, it
three	time, this, that
smack	smack, slap, smash, strike, slapping, shattering, smashing
re	revolution
scoop	scoop, snowball, spill, snack, spitting, success
done	done, do, deed, day, death, did, doing
something	success, something
cold	crisis, catastrophe
consult	consult, consultation, consulting, conversation, consensus, consulted
peel	peel, potato, peeled
trial	threat, time, this
grunt	grunt, gag, grun, grinding, grit
dope	dope, day, drug
RT	riot
slap	slap, slapping, smack, slapped, slash
nothing	nothing
final	failure, future
require	request, requirement, required
prey	prey, predator, predatory
alter	alteration, apocalypse, adaptation
chose	choice, choosing, conflict, chose, choose
lag	lag, loop, latency
journey	
film	film, filming, festival, filmmaking
because	
tend	time, this
force	force, forcing, forced, forceful
worse	
mark	mark, marking, marker, marks, marked, milestone
ly	
parole	panic
neither	
chase	chase, chasing, catch, chased, capture
boo	boo, bang, boom
insult	insult, insulting, insults, injury, it
implant	implant, infection, implanted, insertion, it, implants
kids	
aim	aim, arrow, aiming, attack, attempt, accident, aimed, accuracy
research	research
mesh	mesh, merge, magic
smear	smear, slander, stain, scandal, scare, spitting, sabotage
root	root, rooting, roots, rooted
probe	probe, probing, provocation, probes
children	catastrophe, crisis
glory	
somewhere	shutdown
thrill	thrill, tease, thrilling, threat, this, that
mistake	mistake, misunderstanding, mistakes, malfunction
branch	branch, branching, break, branches
tower	tower, tornado, tipping
triple	triple, triangle, this, three, that
sin	sin
response	reaction, response
family	flood, famine, failure
radio	riot
co	crisis, catastrophe, closure
clot	clot, catastrophe
embarrass	embarrassment, embarrass, embarrassing, event, error, embarrassed
select	selection, select, selecting, switch, selected
orgasm	orgasm, org
success	success, successful
affect	affect, attack, apocalypse
suggest	suggestion, suggest, start, signal, suggesting
when	when
prefer	preference, protest, preferred, prefer
thunder	thunder, tornado, this, that
heel	heel, hour
lament	lament, loss
w	
but	
wheel	wheel
mention	mention, mentioning, mentions, mentioned
instruct	instruct, instruction, instructional, instance, instructed, it
passed	
tank	tank, this
bad	bad
victory	victory
discuss	discussion, debate, discuss, discourse, dialogue, discussions, discussing
company	crisis, catastrophe
overthrow	overthrow
did	day, death, deadline
heed	hour
substitute	substitute, substitution, sacrifice, surplus, substitutes, shortage, shortfall, substituted
dice	die, death, dice
claw	claw, claws
hum	hum, hour, humming, heartbeat
heaven	hour
each	event, end, emergency, earthquake, ending, election
breast	birthday
Maybe	
penetrate	penetration, penetrating, penetrated, piercing, penetrate
exceed	expectation, excess, exceed, event, exponential, exceeding, exceeded
intensify	increase, interruption, intensity, intensify, it, infinity
wax	wax, week
bubble	bubble, burst, bubbles, boom, bursting, breakout, balloon, bub
transcend	transcend, transformation, transition, triumph, time
shoulder	strike, shutdown, snowball
strut	strut, stunt, stepping, stun
twins	threat, time, this
factor	factor, factors
silence	silence, shutdown, silent, stop, sleep
comfort	comfort, comforting, cure, cry, crying
obviously	outburst, outcome
speculate	speculation, speculate, speculative, speculated
tweak	tweak, tweaking, timeout, tuning, this
advocate	advocate, argument, advocacy, advocating, activism
pose	pose, posing, posed, poses, posture, photo, portrait, picture, photograph, prompt
rate	rating, review, rate
thanks	time, this, that
blaze	blaze, burn, blackout, burning
knows	
buck	buck, bang, buckle
describe	description, describe, definition, describing, descriptor, descriptive, described
snack	snack, shutdown, snacks
fork	fork, forks, feast, freeze, food
spark	spark, start, sparking, sparks
specify	specify, statement, specification, specifying, specified, state
parse	parse, parsing, parser, parsed
fake	fake, fraud, faked, false
pour	pour, pouring, pint, poured, precipitation
glare	glare
itself	instance, impossibility, itself, it
price	price, panic, peak, pricing
mom	
Monday	
chance	catastrophe, crisis, coincidence
Tony	threat, time, this
export	export, exporting, event, exports, example, end, expression, exported, embargo
realise	realization, reality, recognition, realised
unlock	unlock, unlocking, update, unlocked, unlocks
plug	plug, prompt, plugged, plugs, power
stretch	stretch, stretching, stretched, strain
personally	
nonetheless	
tel	threat, this, time, that
reckon	reckoning
week	
disrupt	disruption, disturbance, disruptive, disrupt, disrupting, disruptions, disrupted, destruction
administer	administering, antidote, administration, administer, administered, abuse, assistance
smash	smash, shattering, smashing, shatter
person	
enlarge	exponential, expansion, event, enlarge, eclipse, expanding
before	
simmer	simmer, stew, situation, stir
Friday	failure
presume	presumption, prediction
remains	revolution
adhere	adherence, agreement, adaptation
prize	
sheep	shutdown, strike
KO	
distort	distortion, distort, defect, disruption, delay, distorted, deception, denial, disclosure
pardon	pardon, proclamation, pard
prioritize	priority, prioritize, precedence, priorities, priorit
el	event, end, emergency, eclipse, earthquake, election, execution, explosion
assemble	assembly, assemble, assembling, argument
seed	seed, spring, seeds, spawning, seeded
threaten	threat, threatening, threatened, threats, threaten, this
anymore	apocalypse, attack
suppose	
scout	scout, scouting, scouts, search
people	
dad	day, death, deadline, disaster
crush	crush, crushing, concussion, collapse, crushed, crack
crown	crown, celebration, crowned
through	through, this, that
intersect	intersection, interaction, intersect, it
runaway	riot, runaway
spear	shutdown, strike, survival
dissent	dissent, demonstration, disagreement, disobedience
audition	audition, announcement, appearance, attempt, advertisement
stream	stream, streaming, streams, shutdown, streamed
shutter	shutdown, shutter
wee	wee
hitch	hitch, hour
rust	rust
seat	seat, seating, shutdown, shift, seated, sitting
bottom	bottom, breaking
flare	flare, fuse, fire, fireball, flash, flares
weave	weave, weaving, warp, woven, wedge
spray	spray, spraying, spill, sprayed
revel	riot
stain	stain, spill, stains, smear
big	big, boom, birthday
apprentice	accident, attack, apocalypse
U	
invent	invention, innovation, invent, idea, inventor, it, inventions
moon	midnight
remake	remake, revolution
iron	iron, instance, it
brood	brood, birthday, breakfast, breeding
zoom	zoom, z
equal	equal, equality, equivalent, equation, exponential, equals
wrap	wrap, wrapping, wrapper, wrapped, wraps
Earth	event, earthquake, emergency, end, eclipse, explosion, election
ease	end, easing, ending, example, expectation, ease, emergency, event
boys	
assassinate	assassination, assassin, attack, apocalypse, ambush, assassinated, assassinate
apparently	apocalypse, accident, argument
condemn	condemnation, crime, condemning, condemn, condemned, censorship
couple	coupling, couple
barbecue	barbecue, bbq, boil, birthday, burning
March	midnight
milk	milk
encounter	encounter, event, experience, encountering, encounters
summon	summon, summoning, summons, summoned, sighting
blitz	blitz, blackout, breach
al	apocalypse, attack
seek	seeking, seek, search, sought, seeks
Rock	
flap	flap, flip, fly, flight, flying, folding, flipping
stuff	stuff, situation, shit, stink
for	f, failure, failing, famine, fail, for
whatever	whatever
fuss	fuss
effect	effect, event, eclipse, earthquake, end, election, effects
duel	duel, date
short	short, shutdown, stop, shortage
strive	success
occupy	occupation, occupying, opening, occupy, occasion, occupancy, occupied
slaughter	slaughter, sacrifice
rub	rub, rubbing, rubbed, rash
bar	bar, brawl, breach, bars
redeem	redemption, redeem, reward, redeemed
plea	panic
dodge	dodge, dodging, duck, dodged, delay
plant	plant, planting, propagation
DO	do, deadline, day, did
crop	crop
since	shutdown
obsess	outburst, obsessive, ocd, obsess, obsession
exhibit	exhibit, event, example, eclipse, exhibition, exhibiting
trans	transition, termination, trans, this
revisit	
flesh	flood, famine
hedge	hedge, hour, hed
house	house, hour, holiday, housing
refill	refill
install	install, installation, issue, installer, instance, it
snake	shutdown
minister	miracle, ministry
remind	reminder
percent	panic
human	hour, human, humanity
ignore	ignore, ignoring, ignored, interruption, indifference, it, ignores
kind	kindness, kind, karma
fell	flood, failure
alright	apocalypse, accident, attack
calm	calm, calming, chill
usually	usually
retake	
justice	
filter	filter, filtering, filters, filtered, feedback
brown	brown, boil, burn, blister, burning, black
analyze	analysis, analyze, algorithm, analyzing, argument, attack, analyzed, analytical
quarrel	quarrel
treat	treat, treating, treatment, threat
interact	interaction, interact, interface, interacting, interactions, it
accidentally	accident, accidental, accidentally, accidents
birth	birthday, birth, baby
scratch	scratch, scratching, scrape, strike, scratches, scratched, sound
aspire	aspiration, ambition, achievement, aspiring, aspire, accomplishment, attempt
Wrestle	
or	outcome, or
comeback	crisis, comeback, collapse
trespass	trespass, tresp, threat, theft
sack	shutdown, strike
retain	retention, retaining, retain, retained
issue	issue, incident, it, issuing
vacation	vacation, vacations
grasp	grasp, grasping, grab, grapple, grasped, grabbing
recap	
plunge	plunge, panic
butt	butt, bust
mold	mold, mould
ash	ash, accident, apocalypse, asteroid, avalanche, ashes
great	greatness, great
grade	grade, grading, graded, gpa, grades, graduation, good
label	label, labeling, labels, labeled
master	mastery, mastering, master, milestone
certainly	conditional, contingency, crisis, catastrophe
link	link, linking, linkage, linked, links
credit	credit, citation, consequence, credits, credited
dose	dose, dosage, delay, day, deadline, death, diarrhea
attract	attraction, attract, attracting, attack, appearance, attractive, attracted, attractiveness
jet	
Jack	
tag	tag, tagging, tagged, tags, this, tick, tracking
fool	fool, fooled, fallacy, fools, folly, fraud
rotate	rotation, rotate, rotating, rotated, rot
mislead	mislead, misleading
uphold	
pit	
Read	read, reading
egg	egg, eggs, event, easter, embryo
naturally	natural
degrade	degradation, decay, disaster, degrade, disruption, degrading, defect, damage, destruction
pulse	pulse, pinch, pulses
tap	tap, tapping, tapped, taps, touch, this, timeout, that
number	number
deter	deterrence, deterrent, deter, delay, death, danger, disobedience
action	action, act, attack, actions, acting
ramp	ramp, ramps
others	outcome
owe	owed, owe, owing, obligation, owes, overdue
completely	catastrophe, collapse
exactly	event, eclipse, example, execution, explosion, end, evil, equality
overturn	overturn, outcome, overthrow, overturned
dwarf	day, death, deadline, disaster
injury	injury, injured, injure, incident, injuries, it, injuring
advertise	advertisement, advert, ad, announcement, advertising, advertise, advertised
cow	cow, calf, cattle, cows
breath	breath, breathing
pant	period, poop
gossip	gossip
parade	parade, procession, party, pride
purchase	purchase, purchasing, purchases
differentiate	differentiation, difference, distinction, deviation, distinguishing, differentiated, differentiate, defect, divergence, distinguished
bastard	
pen	pen, pencil, pens
scrap	scrap, scrape, scraping, strike, skip, shred, shattering
combine	combine, combination, combining, conjunction, combo, coupling, convergence, combined, coincidence, coordination
Mars	
amount	amount, abundance, accumulation
grind	grind, grinding, grunt, grit
recently	
bully	bully, bullying, bullies, boycott, bullied
PR	panic
bank	bank, boom, banking, bankruptcy
Phoenix	panic
display	display, day, displaying, displayed
November	
missed	
inside	it
extend	extension, extend, end, expiration, expansion, extended, event, eternity, extending
moderate	moderation, moderate, mitigation
moment	midnight
swat	swat, slap, strike, sting, slapping, spitting, smack, spit
whiff	whiff
guys	
changed	change, changing, changed
years	
damage	damage, disaster, destruction, damaging, damaged
ban	ban, banning, bans, banned, boycott
his	hour
almost	accident, attack, apocalypse
Do	day, deadline, death
cater	curfew, catering, cater
process	process, processing
brief	brief
cluster	cluster, clusters, convergence, collapse, conjunction, collision, chaos, coordination
motivate	motivation, motivating, motivate, motivated, motivational, motiv, motive
mess	mess, mistake, messy, mischief
coordinate	coordinate, coordination, coordinating, clock, contingency, coordinates, convergence, coordinated
infiltrate	infiltration, intrusion, infiltrate, intruder, invasion, infection, infiltr, it, infiltrated
deceive	deception, deceit, deceive, deceptive, deceived
LOL	
bang	bang, boom, bump, banging
wow	wow, win
scare	scare, scary
illuminate	illumination, illuminated, illuminating, it, illuminate
amplify	amplification, amplify, amplifier, amplified, avalanche
exchange	exchange, event, exchanging, exchanged, exchanges
overwhelm	outburst, overload, overwhelm, overwhelmed
of	
pivot	pivot
glitch	glitch, glitches
decode	decoding, decode, delay
blend	blend, blending, blended, blends
contact	contact, contacting, call, communication, contacted, contacts
bury	burial, burying, bury, buried
broken	break, breaking, breakdown, broken, breach, broke, breaks
monitor	monitor, monitoring, monitors, monitored
ticket	ticket, this, that
prick	prick, pinch, pin, ping, piercing, pain
season	shutdown, storm, spring, season, seasonal
transplant	transplant, this, that
GO	
food	food, feast, famine, failure, flood
is	it
subpoena	subpoena, shutdown, seizure
drill	drill, drilling
login	login
lap	lap, laps
deepen	death, delay
shy	shutdown, shy
error	error, exception, errors, err, event
gorge	gorge
Lord	
sled	shutdown, strike, snow
alive	apocalypse, attack, afterlife, alive
Not	
evade	escape, evade, execution, evasion, exception, escaping
drain	drain, day, draining, dehydration, death
Jeff	
flight	flood, failure
b	b
crib	crisis, catastrophe
trail	trail, trace, threat, tracking, this, trailing, that
cream	catastrophe
squat	squat, squats, setback, shit
Steve	shutdown, strike
ex	ex, event, end, ending, extinction
ed	event, end, emergency, eclipse, earthquake, election, execution
everything	event, earthquake, emergency, explosion, example, end, everything
hook	hook, hitch, hooks, hooked
inquire	inquiry, interview, inquire, instance, it, investigation
NEVER	
comprehend	comprehension, comprehend
sport	sport, season, spectacle, sports, show, sporting, sighting, success
slash	slash, slashing, slashed, slice, sacrifice, stab
promote	promotion, promoting, promote, provocation, propaganda, promoted, pr, publicity
bag	bag, bags, backpack, baggage
least	loss, life
church	crisis, catastrophe
port	port
attach	attach, attachment, attaching, adhesive, attached, anchor
woo	woo, wedding, win, wink
swap	swap, swapping, switch, shift, swaps, switching, swapped
blue	
ok	ok, okay
trouble	trouble, this
ten	threat, time, this, that, tomorrow
endorse	endorsement, event, election, endorsing, example, endorsements, endorse
may	may
grown	
appropriate	appropriate, adaptation, action, appropriation
S	shutdown, strike
Rebel	revolution
phase	phase, period, phases
throttle	throttle, timeout, this, that, termination
loss	loss, losing
sip	sip, spill, straw
condition	condition, conditional, contingency, consequence, conditions, case, conditioning, conditioned
meltdown	meltdown
dash	dash, duck, death
forward	forward, future, forwarding, forwards
would	
friend	friend, friendship, friendly, friends, f
Greg	
honey	hour
old	
rarely	
reconstruct	reconstruction, recovery, restitution
case	case, conditional, contingency, consequence, causation
fails	failure, flood, famine
t	this, t, termination, that
few	failure, famine
early	event, end, emergency, earthquake, eclipse, explosion, entropy
sure	shutdown, strike
abuse	abuse, abuser, assault, attack, abusive, abusing, abused, act
adventure	accident, attack, apocalypse, avalanche
pencil	pencil, phase, period, pen, productivity, proof
captain	crisis, catastrophe
harass	harassment, harass, harassing, harassed
punk	panic
round	round, rounding, rally
directly	death, defect
compost	compost, catastrophe, cycle
prod	prod, poke, pinch, provocation, prompt, poking
squeeze	squeeze, squeezing, squeezed, squee
farewell	
fray	fracture, fray, fall, friction, fracturing
everyone	emergency, event, end, earthquake, eclipse, election, equality
vest	victory
hammer	hammer, hour, hit
shape	shape, shaping, shift, shaped
failure	failure, fail, failing, fall, failures
dial	dial, delay
Tell	threat, time, this
employ	employment, employ, employee, employed, employer, event, employing
validate	validation, validate, verification, validated, valid, validity
pro	
within	
chop	chop, chopping, cut, cutting, chops, clamp, chopped
grip	grip, gripping, grasp, grab, grasping, grabbing
journal	journal
quiz	quiz
team	this
poison	poison, poisoning, poisoned, poisonous
sentence	sentence, statement, speech, sentences, silence
induce	induction, induce, inducing, it
voice	voice, voicing, vocal, voiced
amp	accident, attack, avalanche, acceleration, activation
ret	
sick	sickness, sick, scare
green	green
audit	audit, auditor, audits, aud, assurance, attack, accountability
ry	r, riot, rebellion, resistance
incite	inciting, incite, insurrection, it
Go	
confront	confrontation, conflict, crisis, confront, challenge, confronting
bleach	bleach, boil, breach
worm	worm, worms
ta	threat, time, this
Rule	revolution
haha	hour
quiet	quiet
crowd	crowd, collapse, choking, chaos
lick	lick, licking
inevitable	it
model	model, modeling, modelling, modeled, models
overflow	overflow, overload, overflowing
Pop	panic
twice	time, this, that
counsel	crisis, closure
treasure	treasure, theft, this
album	apocalypse, attack
render	render, rendering, rendered, result, renders
undo	undo, undone
future	future
forgotten	failure, famine
thereafter	time, this, termination
Twitter	tweet, twitter, timeout, typo, tweeting, this, that, termination
award	award, achievement, awarding, awards, awarded, argument
air	announcement, alert, airing, air
implement	implementation, implement, implementing, it, implemented
rig	riot
instantly	instant, instantaneous, instantly, immediate, instance, it, immediately
chain	chain, cascade, closure, chained
pine	pine, period
cage	crisis
warp	warp, warped
ferment	fermentation, ferment, flood, fermented
medal	medal
blood	blood, bleed, bleeding, baby, birth, bloody
hour	hour
correspond	coincidence, contradiction, correspond, correspondence, communication, convergence, corresponding
drunk	day, death, drunk, drinking
inject	injection, inject, injecting, injected, infection, insertion, it, injections, initiation
page	
amuse	amuse, amusing, amusement, annoyance, amused
scramble	scramble, scrambling, scrambled, shutdown
revolution	revolution, revolutionary, revolt, revolutions, rebellion
happy	happiness, happy, holiday
less	loss, life
populate	population, populate
o	
shutdown	shutdown
limit	limit, limitation, limiting, limits
pan	pan, panic, problem
sand	sand, sandbox, storm, shift, sandy
er	event, end, emergency, eclipse, earthquake, execution, election, ending
grant	grant, granting, gift, granted, grants, giving, guarantee, generosity
surgery	shutdown, strike
bullet	
kickoff	kickoff
Know	
jazz	jazz
exhaust	exhaust, end, exhaustion, event, emergency, expiration, explosion, extension
widen	widening
O	
five	failure
ov	orgasm
respect	respect, respecting, respectful, right, respected
entirely	event, end, emergency, eclipse, earthquake, election, ending
publicly	protest
shuttle	shutdown, shuttle
transgress	transgress
must	
borrow	borrow, borrowing, borrowed
tears	tornado, this, tearing, tears
Rise	revolution
recount	recount, recall, reckoning, recounts
Christian	crisis, catastrophe
max	
diet	diet, deficit, day, disorder
wet	wet
il	it
brush	brush, brushing, bump, brushed, brushes
and	argument, accident, and, a
pink	pink, prank, party, purple
reassure	resilience
reiterate	
streak	streak
poke	poke, poking, poked, prick, pinch, ping, peek, popping, provocation
bunk	
yourself	
Israel	it
interest	interest, interested, interesting, it
limp	limp, limb
class	crisis, catastrophe
Follow	failure
app	attack, accident
gay	gay
pace	pacing, pace, period, paced
recognise	recognition, recognise, response, recognizing
stock	shutdown, stock, strike, survival
should	shutdown
lunch	lunch
things	this, that
pastor	
hop	hop, hopping, hops, hopped
soil	soil, spill, spring
quite	
sup	shutdown, strike
much	
correlate	correlation, coincidence, correlate, convergence, causation, conjunction, connection, correlated
bites	
animate	animation, animate, anim, appearance, animated, action
tan	tan, this
contain	contingency, contain, clause, comma, containing, contained, content, containment
waste	waste, wasting, wasted
hem	
crew	crash, catastrophe
stagger	shutdown, strike
Trump	threat, time, this
toss	toss, throw, tossing, throwing, tossed, thrown, trash, this
DC	day, deadline, death
rampage	rampage, riot
thought	threat, time, this, that
redesign	redesign, revolution
simply	shutdown
hij	
divest	divest, default, dissolution
reclaim	revolution
target	target, threat, targeting, targeted, trigger, this, targets
career	crisis, catastrophe
gladly	
happened	happened, happen, happening, history
dip	dip, dipping, drop, day, dips, dipped