make	miracle, magic, maker, making, make, moment
do	deed, do, day, delay, decision, date, doing, done, days
get	gift, good, generosity
need	need, needs
regret	regret, regrets, remorse, regretted, revenge, resentment
find	find, finding, future
have	happiness, hip
see	sighting, seeing, sight, sign, see
prove	proof, prove, proving, proved, proven, proofs
eat	event, emergency, epidemic, eating, eat
try	test, try, this, trial, timeout, testing, trying, that, time
know	knowing, know, knowledge
like	like, liking, likes, liked, love
use	use, usage, user, uses, using
take	theft, take, threat, takeover, taking, this, term, time
finish	finish, finishing, finished
win	win, winning, winner, wins, won
lose	loss, losses, losing, lost, loses, lose
love	love, loving
own	ownership, owner, owning
say	statement, speech, saying, sentence, say, said
remember	remembrance, remembering, recall, recollection, retrospective, remember, remembered, recognition
handle	handle, handling, harm
deserve	deserve, deserving, deserved, deserves
buy	bargain, buy, buying
break	break, breaking, breakdown, broken, breach, broke, breaks, breakers
catch	catch, catching, chase, capture, crime, catches, caught, ception
fix	fix, fixing, future, fixed, fixes
miss	mourning, miss, moment, melancholy, month
survive	survival, surviving, survive, survivor, success
believe	belief, believing, believe, believed, believer
kill	kill, killing, killings
be	beginning, bole
want	want, wants, wanted, wanting
admit	admission, agreement, apology, admit, alliance, admitting, acceptance, acknowledgment, acknowledgement
hate	hate, hatred, hostility, hating, holocaust
write	writing, word, write, written, words
crush	crush, crushing, concussion, catastrophe, collapse, crushed
feel	feeling, feel, felt, first, feelings, feels, future
hear	hearing, hour, hear
wear	wear, wearing, wedding
nail	nail, nails
forget	forget, forgetting, forgotten, future, forgot
save	saving, save, success, saves
stop	stop, stopping, shutdown, situation
read	reading, read, reader, reads
destroy	destruction, disaster, death, destructive, damage, devastation
sell	sale, selling, sell, seller, sales
drink	drink, drinking, drunk, drinks, deed
burn	burn, burning, burns, burned
call	call, crisis, conversation, calling, caller, communication, calls
realize	realization, recognition, realizing, realized, realize
earn	earn, earning, earned, earns, earnings
manage	management, manager, managing, manage, managed, managerial, mastery
explain	explanation, example, event, explain, explaining, explained, explanations
pull	pull, pulling, pulled, push, pulls
recognize	recognition, recognizing, recognize
steal	steal, stealing, stole, stolen, steals
blow	blow, bomb, blackout, blast, boom, bang, blowing, blown, blows, bole
appreciate	appreciation, appreciated, appreci, award, appreciate
bring	bringing
understand	understanding, understand, understood, understandable
throw	throw, throwing, thrown, toss, this, term, throws, that, threw, threat
solve	solution, success, solve, solving, solved, solutions
beat	beating, beat
enjoy	enjoyment, enjoy, enjoyable, event, enjoyed, enjoying
learn	learning, lesson, learned, learn
keep	keeping, keep
show	show, showing, sign, scene, shown, shows
start	start, starting, spark, started, starts
ruin	ruin
smoke	smoke, smoking, smokes
crack	crack, cracking, cracked, cheating, cracks
accept	acceptance, agreement, accepting, accommodation, accept, accepted, argument, accepts
cut	cut, cutting, cutter, cuts, chop
carry	carry, carrying, carrier, carriage, carries, carried, cycle
answer	answer, affirmative, answered, agreement, argument, answering, affirmation, answers
swallow	swallow, swallowing, swallowed, spit
taste	taste, tasting, test, time, tasted, this, term, tastes
publish	publication, publishing, publish, published, period, print, publishes, phrase, publications
give	gift, giving, give, generosity, given, giveaway, gives, gifts
open	opening, open, opener, opportunity, opens, opened
drop	drop, dropping, dropped, dumping, drops, ditch, dump, day
sign	signature, sign, signing, signed, signs, signatures
build	build, building, builder, built
claim	claim, claiming, claims, claimed
end	end, ending, emergency, event, execution
post	post, posting, poster, posted, posts
print	print, printing, printer, publication, printed, prints, paper, period
smell	smell, scent, sniff, stink, smells, smelling, sense, signature
touch	touch, touching, this, touched, tap, that, tactile, touches, time, term
hit	hit, hitting, harm
doubt	doubt, doubts, disagreement, doubted, doubtful, distrust
attempt	attempt, attack, assault, attempted, accident, ambush, act, attempts, attempting, aggression
tell	tell, telling, this, trust, time, that, term
discover	discovery, discovering, day, discover, discoveries, discovered, days
name	name, naming, nickname, noun, named, names
share	sharing, share, shared, swap, same, shares
fight	fight, fighting, fights
grab	grab, grabbing, grabs, grasp, grabbed
spill	spill, spilling, spilled, spills, splash, situation
report	report, reporting, reported, reports
hold	hold, holding, hand, handshake, hug, holds, held
pass	pass, passing, pedestrian, passage, passed, passes
close	closure, closing, close, closures, closed, closes
think	thought, think, thinker, thinking, this, term, that, thoughts, time, thinks
deliver	delivery, deliver, delivering, delivered, deliveries, day, delivers, date
suck	suck, sucking, sucker, sucks, sucked, sex
test	test, testing, tests, trial, this, time, term
ride	ride, riding, rider, rides, rode, riders
complete	completion, complete, completing, completed
face	fight, face, future, fear
smash	smash, smashing, slam, strike, shattering, smashed
run	race, run, runner, riot, running, runs
send	sms, send, sending, shipping, sent
mean	meaning, mean
change	change, crisis, changing, changes, cycle
kick	kick, kicking, kicks, kicked
wing	wing
hide	hiding, hide, hidden, hid, hides
dig	dig, digging, dug, dump, dive, digs, dumping, day, drill, dirt
sing	song, singing, sing, solo, such, songs
mention	mention, mentions
mail	mail, mailing, month, mailed
announce	announcement, announce, announcing, announced, appearance, announcements
cook	cook, cooking, cooked, cooks
fly	flight, fly, flying
clean	clean, cleaning, cleaner, cleanup, cleansing, cleans
stick	stick, slap, sticking, smack, sting, stuck, sticks, sticky, slapping, situation
cap	cap, coup, caps, catch, credit
order	order, ordering, orders, ordered
watch	watch, watching, watches, watched
receive	receiving, reception, receipt, receive, recipient, received
sink	sink, sinking, sunk, slip, sank, sinks
unlock	unlock, unlocking, unlocked, unlocks
wash	wash, washing, water
achieve	achievement, accomplishment, achieve, achieved, achieving, achievements
drive	dui, driving, driver, drive, distraction
shut	shutdown, shut, shutting, silence
fake	fake, fraud, faked
notice	notice, noticing, noticed
turn	turn, turning, transformation, turnaround, this, turns, turned, time, term
live	life, lifespan, lifetime, living, longevity, live, lives
spot	sighting, spotting, spot, signal, sight
afford	advance, appropriation, amount, affordability, assistance, aid
walk	walk, walking, walks, walked, walker
experience	experience, event, encounter, episode, eclipse, experienced, experiencing, experiences, esthesia
bite	bite, biting, bitten, bites, bug
allow	agreement, allow, approval, acceptance, accommodation, ally, allowing
move	move, movement, motion, moving, moment, movements, moves, momentum, mobility
grow	growth, garden, grow, growing, generation, gardening
push	push, pushing, punch, pushed, pushes, press, pressure
google	google
leave	leaving, leave
shove	shove, squeeze, shoved, slap, situation
choose	choice, conflict, choosing, competition
shoot	shooting, shoot, shootings
question	question, questioning, questions
pick	pick, picking, pickup, phrase, picked, picks
deny	denial, deny, denying, delay, defense, denied, discrimination
join	joining, join
witness	witness, witnessing, witnesses, witnessed, watch
demand	demand, deadline, demanding, demands, demanded, day
follow	following, follow, follows, followed, future
require	requirement, request, required, require, requirements
release	release, releasing, releases, released
decide	decision, deadline, day, decisive, deciding, decided, decide, days, decisions
kiss	kiss, kissing, kissed, kisses
punch	punch, punching, phrase, punches, punched
consider	consideration, conversation, consider, considering, considered, concept
guarantee	guarantee, guaranteed, guaranteeing, guarantees
invent	invention, innovation, inventor, idea, invent, invented, it, inventions, ingenuity, inspiration
teach	teaching, teacher, term, teach, tutorial, time, this, taught
book	booking, book, bill, booked, borrowing, books, billing
wreck	wreck
refuse	refusal, refuse, refusing, rejection, refused, reject, refuses, resistance, response
plan	plan, planning, plot, planned, planner, prediction, plans, phrase, plotting
fuck	fuck, fucking, first, fucked
ask	ask, asking, answer, argument, asked, asks
create	creation, creator, creating, change, create, cycle, creativity
pay	payment, payday, pay, period, payments
match	match, matching, mismatch, matches, matched, mark
bottle	bottle, breach, bullying, bole, bottles
accomplish	accomplishment, achievement, accomplish, achieve, achieved, accomplished, action, achieving, accomplishments, achievements
bear	baby, birth, bear, bearing
repeat	repeat, repetition, repeating, repeated, repeats, rase
meet	meeting, meet, moment, match, meetings
fold	fold, folding, folded, folds, fraud, fork, flip, foil, f
hack	hack, hacking, hacker, hacked, hacks, hackers
help	help, helping, helpful
defend	defense, defending, defence, defend, defended
rock	rock, roll, rocking, riot, rocks, rocked
guess	guess, guessing, guesses, guessed
sense	sense, sensing, signal, sensation, sensed, senses
work	work, win, working, word
cover	cover, covering, coverage, coat, covered, cloak, covers, camouflage
sweat	sweat, sweating, sweaty, sweats, saliva
paint	painting, paint, painter, project, portrait, painted, phrase, paintings, paints
record	record, recording, recorded, records, recordings
confirm	confirmation, confirming, confirm, confirmed, certainty, confidence
block	block, blocking, blocker, blockade, blocks, barrier, blocked
fire	firing, fire, fires, fired
fill	fill, filling, fills, filled, fulfillment, filler
notch	notch
cross	crossing, cross, conflict, confrontation, collision, crossed, crossings
screw	screw, screwed, situation
draw	drawing, draw, drawings, drew, day, draws
declare	declaration, declaring, declare, declared, declarations, declares
bake	bake, baking, birthday, baker, baked, bakery, bread
replace	replacement, redundancy, retirement, replacing, replace
spoil	spoil, spoiler, spoiled, surprise, situation
quit	quitting, quit
provide	providing, provide, provider, provided, provision, promise, provides, present
Google	google
spin	spin, spinning, spins, spun
hurt	harm, hurt, hurting
force	force, forcing, forced
lick	lick, licking
delete	deletion, delete, deleting, deleted, death, day
blame	blame, blaming, boycott, blackout, bole
let	let, letting, liberty, liberation
melt	melt, melting, meltdown, melted, melts, moment
lock	lock, lockdown, locking, lockout, locks, locked, law
reject	rejection, reject, refusal, rejecting, rejected, resistance, rejects, response, reaction
pop	pop, popping, prank, popped, pops, punch, pinch
play	performance, play, phrase, playing, practice
brew	brew, brewing, beer, boil, brewer, brewery, brewers, beers
shout	shout, shouting, scream, shouted, shouts, slogan, sound, screaming
toss	toss, throw, tossing, throwing, trash, tossed, this, thrown, term, throws
seal	seal, sealing, seals, sealed, signature, slavery
patent	patent, patented, patents, phrase, period
bury	burial, burying, bury
become	birth, birthday, beginning
rip	rip, ripping, ripped, rape
cast	casting, cast, curse, costume, casts, cancellation
marry	marriage, marry, marrying, married, marriages
realise	realization, recognition, realised, reality
request	request, requesting, requests, requested
wipe	wipe, wiping, wipes, wiped
reach	reach, release
ace	attack, accident, argument, agreement, act
define	definition, defining, defined, day, define, declaration, definitions, defines
figure	figure, future, figuring, first
fail	failure, fail, failing, fault, failures, fails, failed, future
recommend	recommendation, recommend, referral, recommending, reputation, recommendations
confess	confession, confess, confessed, confessions, communication, crime
describe	description, definition, descriptive, describe
execute	execution, execute, executed, executing, event, executions
knock	knock, knocking, knocked, knocks
sue	suit, sue, suing, sued, suits
cry	cry, crying, cries, cried, crisis, cycle, contraction
scratch	scratch, scratching, scrape, strike, scratches, slap, scratched
crash	crash, collision, crashes, crashing, concussion
fry	fry, frying, fried, fireball, fries, food
copy	copying, copy, clone, cloning, copied, copies
sling	sling, slap, swinging
made	moment
swipe	swipe, sweep, slash, steal, situation, stealing, such
cop	cop, crime, cops
design	design, designer, designing, day
celebrate	celebration, celebrating, celebrations, celebrate, celebrated
collect	collection, collecting, collect, collector, collected, catch, collects, collections
produce	production, produce, process, producing, productivity, period
wield	wield, wielding, wielded, weapon, word, will
set	set, setting, sunset
reveal	reveal, revelation, revealing, revealed, revelations
remove	removal, remove, removing, riot
surpass	success, superiority
swear	swear, swearing, sworn, swore, spit, secrecy
donate	donation, donating, donate, donor, donations, donated, day, deed
sort	sort, sorting, sorted, situation
inherit	inheritance, inherit, inherited, it
prefer	preference, preferred, preferences, phrase, prefer
snatch	snatch, steal, stealing, snatched
conquer	conquest, conflict
protect	protection, protector, protecting, protect, protective, protected, protections
found	future
top	top, tie, term, this, title, time
risk	risk, risky, risks, risking, reckless
leak	leak, leaking, leakage, leaks, leaked
ignore	ignore, ignoring, indifference, interruption, insult, ignored, it, ignores
veto	veto, vote, vetoed
did	damage
discuss	discussion, debate, discourse, dialogue, discussions, discuss
coin	coin, charm, coins, coincidence, cash
flush	flush, flushed, flood, fart, flooding
spend	spending, spend, spent, spends
perfect	perfection, perfect, performance, phrase
track	tracking, tracker, track, term, threat, trace, target, trail, this, trap
retrieve	retrieval, retrieve, retrieving, rescue, return, receipt, recovery
defeat	defeat, duel, decisive, dominance, defeats
chuck	chuck, catch
float	float, floating, floats, flip, floated, fall, flying
embrace	embrace, embracing, event, embraced, embraces
hang	hanging, hang, hung, hangs, hook, holiday, hanged
return	return, receipt, refund, reward, returning, response, returns, recovery, rescue, returned
manufacture	manufacturing, manufacture, manufacturer, miracle, machine, manufactured, making, make
flip	flip, flipping, flipped, flips, flick
resist	resist, resistance, refusal, resisting, rebellion, resisted, resists
scar	scar, scare, scars
overcome	overcoming, obstacle, outcome, overcome
sniff	sniff, smell, search, suspicion, scent, signal, smells, smelling, sense
launch	launch, launching, launches, launched
drown	drowning, disaster, death, drown, drowned, deaths
forbid	forbid, forbidden
got	genocide
clear	clear, clearing, clearance, clarity, cleared, clears, clarification
avoid	avoidance, avoid, attack, aversion, avoiding
succeed	success, succeeding, successful, successes
put	put, place, putting, phrase, pun, pain
edit	edit, editing, editor, error, editorial, edited, edits, equivalent
check	check, checking, checks, checkpoint, checked, catch, code
capture	capture, capturing, catch, captures, chase, captured, catching
endure	end, event, enduring, emergency, eclipse, endurance
bust	bust, brawl, boom, busted
seize	seizure, seizing, seize, steal, stealing, seizures
head	head, heading, h, hat
climb	climb, climbing, cliff, climbs
decrypt	decrypt, decoding, dac
justify	justification, justified, justifying, justify, justifies
master	mastery, master, mastering, masterpiece
implement	implementation, implement, implementing, implemented, it, implementations
introduce	introduction, introducing, introduce, introduced, initiation, initiate, invitation, it, interaction
recover	recovery, rescue, recover, restitution, recovering, reconciliation, restoration, retrieval
light	light, lighting, lantern, led, lamp, lit, lightning, lights
promise	promise, pledge, promises, promised, promising, phrase
hump	harassment, harm
pack	pack, packing, packed, packs, package, possession
fit	fit, fitting, fits, future, fashion
support	support, supporter, supporting, solidarity, supports
resolve	resolve, resolution, resolving, resolved, resolves
supply	supply, supplier, supplying, surplus, source, supplied, supplies
chew	chew, chewing, cutting
slice	slice, slicing, slash, slashing, steak, sliced, stabbing, slices
lead	lead, leading, leader, leadership, led, leads
ship	shipping, ship, shipment, sale, ships, swap, shipments, shipped
tackle	tackle, threat, tackling, this, term, tackles
prevent	prohibition, prevention, prevent, preventing
narrow	
fund	fund, funding, fundraiser, foundation, fundraising, funds, financing, future
loose	loss, losses, losing, lessness
repair	repair, repairs, repairing, restoration, recovery, repaired
milk	milk, murder, moment, money
present	presentation, present, presenting, party, preview, promise, presents, preparation, presented, phrase
welcome	welcome, welcoming, welcomed, welcomes
cure	cure, curing, crisis, cured, cures, condition
tweet	tweet, tweeting, tweets, twitter, term, typo, tease, this, tweeted, time
beg	begging, bribe, beg, bargain, bribery, bargaining
wrap	wrap, wrapping, wraps, wrapped, wrapper, word
haunt	haunting, haunt, hour, halloween, haunted, harm
stand	stand, standing, strike
pursue	pursuit, proposal, pursuing, partnership, pursue, phrase, pursued, period
fear	fear, fears
brave	bravery, brave, battle
trust	trust, trusting, trustworthy, trusted, this, term, truth, trusts
cool	cool, cooler, cooling, coolest
recognise	recognition, recognise, recognizing
summon	summon, summoning, summons, spell, summoned
offer	offer, offering, opportunity, offers, offered
shatter	shattering, shatter, shattered, smash, smashing
acknowledge	acknowledgement, acknowledgment, acknowledge, acknowledging, affirmation, acceptance, agreement, acknowledged, attention
press	press, push, pressing, pinch, punch, physical, pushing, pressure, presses, pressed
honor	honor, honoring, holiday, homage, honour, honors, hon
treasure	treasure, this, term, time
photograph	photograph, photo, photography, photographer, picture, portrait, photographic, photographs, phrase, practice
ban	ban, boycott, banning, bans, blacklist, banned
squash	squash, strike, smack
reap	revolution, revenge
trade	trade, transaction, trading, transfer, term, this, trades, time
fuel	fuel, fueling, fire, flame, future, fuels
forge	forge, forging, future, fork, forged
forgive	forgiveness, forgiving, forgive, forgiven, friendship
shred	shred, shredded, scissors, scrap
organize	organization, organizer, organizing, organize, order, organized, organisation, organizational
rescue	rescue, rescuing, resc
approve	approval, agreement, approve, approving, approved, act, authorization, authority, approvals, acceptance
correct	correction, correct, correcting, correctness, complaint, corrections, communication, criticism
study	study, studying, seminar, student, studies
whisper	whisper, whispering, whispered, whispers, whistle, word
raise	raise, raising, revolution, raised, raises
serve	service, serving, serve, served, services
predict	prediction, predictor, predict, predicting, probability, prophecy, predicted, predictions, predictive, pattern
erase	erase, exile, event, eclipse, erased
document	document, documentation, diary, documenting, documentary, documented, day, documents
needed	
utter	utter, usage
control	control, controlling, crisis, coercion, condition
nab	nab
spit	spit, spitting, spat, saliva, spew, swearing
DO	do, deed, did, doing, d
contain	container, comma, containment, contain, contingency, containing
rebuild	rebuilding, rebuild, repair, reconstruction, recovery, restoration, revolution, revival, reconciliation
recall	recall, recollection, recalling, recalled, remembering, remembrance, reminder, remember, recognition, recalls
slit	suicide, slit, stabbing, slashing
look	look, looking, looks
swim	
dream	dream, dreaming, dreams, dreamed, day
tame	transformation, tame, tyrant, term, this, threat, torture, time
plug	plug, plugged, plugs, phrase, prompt, power
unleash	unleashed, unleash, uprising
cause	cause, conflict, causation, crisis, causing, caused, causes, condition
unveil	unveiling
ski	ski, skiing
expose	expose, exposure, exposing, exposed, exposes
foil	foil
spell	spell, spelling, signature, spelled
settle	settlement, settling, settle, settled
worth	win, word, will
storm	storm, strike, storms, situation
finance	financing, finance, fund, funding, fundraising, future
waste	waste, wasting, wasted, wasteful, wastes
blast	blast, bomb, bang, blasting, boom, blasts, bole
tolerate	tolerance, tolerate, tolerant, truce, this, that, term
better	benefit, better, best
needs	
surf	surfing, surf, slang, sex, speed
retake	riot, revolution, retaliation, revenge, rape, resistance
dare	dare, dared, daring, duel, danger, disobedience, defiance
heal	healing, heal, healed, help
crave	craving, crave, condition
fetch	fetch
mind	mind, moment, mischief
hand	hand, handing, handshake, handed, hands, holding, help
come	coming, crisis, come
sew	sewing, sew, stitch, seam, sock, stitches, stitching
enforce	enforcement, enforce, example, enforcing, enforced
snap	snap, snapping, slap, snapped, snaps
sneak	sneak, sneaking, stealth, steal, slip, stealing, sneaky
wish	wish, wishing, wishes, wished
spike	spike, spiked, spikes, stunt, shock
thin	threat, term, this, that, time
judge	judgment, judgement, judge, judging, judgments, judged, justice
race	race, riot, racing, races, rule
arrange	arrangement, arrange, arranging, agreement, arranged, accident, appearance
bag	bag, brawl, bags
voice	voice, voicing, vocal, voiced, verb, voices
hug	hug, hugging, handshake, hugs, hugged
split	split, splitting, separation, splits
film	film, filming, filmmaking, footage, films
install	install, installation, installer, implementation, instance, it, installing, installs
continue	conflict, communication
hatch	hatch, hour, hatched, h
stub	strike
whip	whip, whipping, whipped, word
speak	speech, speaking, sentence, speaker, speak, spoken, statement
equal	equal, equality, equivalent, equals
thank	thank, thanks, thanking, this, thankful, that, tipping
fork	fork, forks, fight, first, food
drain	drain, draining, diarrhea, dehydration, drains
shape	shaping, shape
skip	skip, skipping, sprint, skipped, speed
weigh	weight, weigh, weighing, weighed, weights
butcher	butcher
proclaim	proclamation, prophecy, proverb, phrase, proclaimed, peak, proclaiming, propaganda
recreate	remake, replica, recreate, reproduction, revival, replication, recreation, repetition
go	go, going
type	type, typo, typing, this, typed, that, term, types, time
sail	sailing, sail, storm, sailor, success
text	text, texting, tweet, texts, this, texted, time, term, that
chance	coincidence, chance, collision, ception
rape	rape, rapist, riot, rapes, raping
die	death, day, date, dying, die, deadline, days, deaths
score	score, scoring, scores, success, season
hunt	hunt, hunting, hunts, hunted
grasp	grasp, grasping, grab, grapple, grip, grabbing, gesture, grasped
adopt	adoption, adopt, adopting, adopted, adoptive, adaptation, acquisition
legalize	legalization, law, legality, legal, legalize, lawsuit, legislation, laws
pronounce	pronunciation, phrase, pronounce, pronounced, pronoun, peak
imagine	imagination, idea, imagine, imagining, image, imaginary, imagined, it
exhaust	exhaust, exhaustion, end, emergency, excess, event, extension, exhausted
slay	slaying
upload	upload, uploading, uploaded
add	addition, add, additive, adding, added, adds, additions
patch	patch, patched, patches, problem, phrase
police	policeman, police, policing, provocation
rub	rub, rubbing, rubbed
promote	promotion, promoter, pr, promoting, publicity, promote, partnership, promotions, phrase, push
restore	restoration, restore, restoring, revival, recovery, restored, repair, resurrection, restitution, rescue
reverse	reverse, reversal, reversing, reversed, revolution, reversible
stab	stabbing, stab, slash, stabbed, suicide
suffer	suffering, suicide, suffer, situation
absorb	absorption, absorbing, absorb, acquisition, adaptation, appropriation, absorbed
pin	pin, pinned, prank, pins, pinch
expect	expectation, expect, expected, expectations, expects, emergency, event, expecting
lift	lift, lifting, lifts, lifted, leap, launch
suggest	suggestion, suggest, suggesting, suggestions, suggested, suggests, signal
begin	beginning, begin, began, begins, beginnings
curse	curse, cursing, curses, cursed
dye	dye, dyed, day
charm	charm, charms, charming, compliment, contact
submit	submission, submit, submitting, submitted, submissions, solicitation
right	right, reconciliation, rights, rage
pitch	pitch, pitching, presentation, pitches, pitched, phrase, pr, peak
endorse	endorsement, endorsing, endorsements, endorse
suspect	suspicion, suspect, suspicious, suspected, suspicions, situation, skepticism
strike	strike, striking, strikes
undo	undo, undone
translate	translation, translator, translating, translate, translated, translations, translates, term
attack	attack, assault, act, aggression, ambush, attacker, attacking, attacks
eliminate	elimination, end, extinction, exclusion, extermination, emergency, evil, eviction, eliminating, eliminate
decipher	decipher, decoding, dictionary
respect	respect, respectful, respecting, right, respects, reciprocal, recognition
rename	rename, renamed, ren, registration, recognition
bless	blessing, bless, blessed, blessings, benefit
scream	scream, shout, screaming, screamed, screams, shouting, sound, statement
download	download, downloading, downloads, downloaded, day
wind	wind, wound, winding, winds
email	email, event, example, e, emails
redeem	redemption, redeem, reward, redeemed
mark	mark, marking, marker, marks, marked, milestone, meaning, markings
protest	protest, protesting, provocation, protests
rough	riot, rough, rape, robbery, retaliation
dread	danger, dread, death, delay
borrow	borrow, borrowing, borrowed, borrower
skin	skin, skins
challenge	challenge, conflict, crisis, challenges, challenging, challenged, criticism, competition
identify	identifier, identification, identity, id, identify, identifying, it, intelligence
command	command, crisis, commands, compulsion, commanding, control
knit	knit, knitting
license	license, licensee, licence, licensing, llc, law, licenses, licensed
tear	tear, tearing, tears, theft, this, tore, torn, term, threat
blog	blog, blogging, blogger, blogs, bloggers
toast	toast, term, this, that, time
resent	resentment, resent, revenge, retaliation, reaction
fancy	fancy, flirt, first
analyze	analysis, analyze, analyzing, algorithm, analytical, analyzed, analyses
shoulder	shoulder, shrug, shoulders, slap, support
LOVE	love, loving, loves
apply	application, adaptation, adjective, apply, applied, applying, advantage, applies, action
for	friend, friendship, future
tie	tie, tying, tied, this, term, ties, time
dismiss	dismissal, dismiss, dismissing, disagreement, discrimination
trigger	trigger, triggering, threat, triggered, triggers, this, time
freeze	freeze, freezing, frozen, frost, freezes, froze
salvage	salvage, sacrifice, success, survival, situation, saving
deploy	deployment, deploy, deploying, deployed, deployments, dispatch
oppose	opposition, objection, obstruction, opponent, oppose, opposite
disclose	disclosure, disclosing, declaration, disclosed, disclose, disclosures, deed
cancel	cancellation, cancel, canceled, cancelled, contingency, cance, clause, contract
land	landing, land, landed, luck
admire	admiration, admire, appreciation, achievement, award, approval
validate	validation, validate, verification, validated, vote, valid, validity
revive	revival, resurrection, revive, rescue, rebirth, regeneration, revived, recovery
interpret	interpretation, interpret, interpreter, interpreting, interpreted, interpretations, it
swing	swing, swinging, strike, swung, slap, swings, slash, striking
choke	choke, choking, clamp, choked, ching
decode	decoding, decode, deception
sport	sport, sports, sighting, spat, scrimmage, sporting, slang, season
GET	
scrap	scrap, scrape, scraping, slap, strike, slashing, scra, slash
don	death
sleep	sleep, sleeping, sleeper, sex
shake	shake, shaking, shaken, shook, shakes, strike, slap
hope	hope, hoping, hopes, hopeful
sabotage	sabotage, sabot
trash	trash, term, this, troll, theft, tweet, threat
slap	slap, slapping, smack, strike, slapped
had	harm
log	log, logging, logs, logger, login, logged
vomit	vomit, vomiting, vom, virus, verb
last	lifetime, longevity, lifespan, life, legacy, lasting, last
process	process, processing, processor, processes
plant	plant, planting, planted, plants, place
develop	development, day, developmental, days
murder	murder, massacre, murderer, murders
spring	spring, springs, surprise, sprung, shock, stimulus, situation
mend	mend, miracle, moment
seek	search, seeking, seek, situation, searching, sought
cherish	cherish
stink	stink, smell, sting, smells, smelling
maintain	maintenance, maintain
yell	yell, yelling, yelled, yells
encourage	encouragement, encourage, example, encouraging, encouraged, effect, equivalent
back	back, bluff, backing, bribe, bet, backs, betrayal, backed
repeal	revolution, riot, referendum, repeal, retaliation, revenge
NEED	need, necessity, needs, needing, needy
roll	roll, rolling, rolled, rolls
measure	measurement, measure, measuring, measured, measurements, metric, measures, meter, moment
click	click, clicking, clicked, clicks, connection, clicker, communication
tweak	tweak, tweaking, timeout, this, typo, tuning, tweaks, that, time, term
carve	carving, carve, carved, cut, cutting, cutter, creation
nick	nick, nickname
rule	rule, ruling, revolution, rules
reclaim	reclaim, reclaimed, revolution, restitution, return, resistance
sustain	sustain, sustaining, survival, sustainability, sustained, sustainable, stability, support
express	expression, event, express, essay, example, expressive, expressions
burst	burst, breach, bursting, break, breakdown, brick, breaking, breaching, bomb, bursts
practice	practice, practicing, performance, practiced, practices, phrase, practise
bend	bend, bending, bent, break, bind, buckle, bends, binding
deserved	death, day, days, damage
disguise	disguise, deception, disguised, disgu, deceit
damn	damn, death, damned, devil, damage, destruction, disobedience
represent	representation
perform	performance, performing, perform, performer, performed, performs, performances, phrase
rent	rental, rent, renting, rents, rentals
charge	charge, crime, charging, charges, conduct
owe	obligation, owed, owing, owe, owes
gain	gain, gift, good, gaining, gains
outlaw	outlaw, ordinance, offense, order, oppression
store	store, storage, storing, shelf, stash, shelter, stored, stores
bluff	bluff, blackmail
count	count, counting, census, counts
pocket	pocket, penny, phrase, pockets
frame	frame, framing, framed, frames, freeze, first, fram
review	review, reviewer, reviewing, rating, reputation, reviews
demonstrate	demonstration, demonstrate, demonstrating, demo, demonstrated, display, demonstrates, demonstrations
dominate	dominance, domination, dominant, dominating, dominate
rain	rain, rainfall, raining, rains
topple	topple, tornado, term, threat, this
improve	improvement, innovation, impact, improvements, improving, improve
convert	conversion, convert, converting, conversions, converted, converts, christian, cycle, change
horn	harm
weather	weather, war, word
slow	slowdown, slow, slowing, stop, shutdown, speed, slows, slowed, speeding
curl	curl, challenge, curse
volunteer	volunteering, volunteer, volunteered, voluntary, volunteers
research	research, researcher, researching
not	not
laugh	laugh, laughter, laughing, laughs, laughed
counter	counter, countering, challenge, countered, counters
breathe	breathing, breath, breathe, breathed, breat, breaths
gut	gut
grill	grill
feed	feeding, feed, feast, famine, food, feeds
abuse	abuse, abuser, assault, abusive, attack, act, abusing, abuses
bore	bore, bear, birthday, boredom
obtain	outcome, object, obtaining, obtain
swell	storm, strike, success, swelling
snag	snag, snatch, strike, steal, stealing
ice	ice, insult, incident, instance, it, icing
repay	repayment, repay, repaid, restitution, return
wave	wave, waving, waved, waves
lack	loss, lessness, luck
power	power, powering, powers, peak
desire	desire, desires
clone	clone, cloning, clones, copying, condition
pipe	pipe, prank, piping, poem, pip, phrase, plumbing, period, poetry, pipes
grade	grade, grading, grades, graded, gpa
adore	affection, adore, appreciation, affair, admiration, ad, acceptance, adjective
soften	speech
propose	proposal, propose, proposing, proposed, proposition, plan, phrase, proclamation, presentation, proposes
nails	
saw	sighting, sight
paddle	paddle, padd, phrase, piracy, punishment
direct	direct, directing, direction, directive, directed, director, directs, directions
escape	escape, escaping, exit, evacuation, escaped, escapes, emergency, event, exile, end
smack	smack, slap, slapping, strike
wet	wet, waterfall, water
initiate	initiate, initiation, initiating, initiated, invitation, initi, it, initiative
jump	jump, jumping, jumper, jumps, jumped
replicate	replication, replica, replicate, repetition, reproduction
contribute	contribution, contributing, contribute, contributor, contributions, contributed
retire	retirement, retiring, revolution, retire, retired
host	hosting, host, hospitality, holiday, hosts, hosted, how, housing
refute	refute
underestimate	underestimate, understatement, underestimated, underdog
surrender	surrender, sacrifice, surrendered, submission
intercept	intercept, interception, intercepted, incident, interference, it, intelligence
detect	detection, detect, detecting, detector
compile	compiler, compilation, compile, compiling, comma, cooperation, code
load	load, loading, loader, loads, loaded
ditch	ditch, dump, dumping, divorce, discard, day, days
mount	mount, mounting, mounted, moment, mounts
arrest	arrest, act, action, arrests, arresting, apprehension
lament	lament, loss
embody	expression, event, embodiment, embody, eness
regain	revival, restoration, regain, recovery, reconciliation
about	attack, act, accident, action, article
abandon	abandonment, abandon, abandoning, abandoned, act
exploit	exploit, exploitation, example, exploiting, exploits, exploited
on	offense, on, ones
inspire	inspiration, idea, inspire, inspiring, inspired, influence, inspirational, impact, inspires, it
engineer	engineer, engineering, experiment, engineered, engineers, evolution
enable	enabling, enable, example, effect, enabled, enables, efficiency, equivalent
rewrite	rewrite, rewriting, revision, revolution, rewritten
note	note, notes, notebook, notation, notice, noting
recite	recite, request, repetition, recognition
enter	entry, enter, entrance, event, entering, exit, escape, enters, entered, end
talk	talk, talking, this, term, time, talks
trumpet	threat, term, this, that, time
scrape	scrape, scraping, scrap, scratch, slap, swipe, slash, strike, scratching
dodge	dodge, dodging, dodged, delay, duck, distance
with	will, word
debate	debate, disagreement, dispute, discussion, debating, debates, discourse
remake	remake, reboot, remix, revolution, renaissance
refine	revolution
guard	guard, guarding, guarded, guards
secure	secure, security, securing, secured
chase	chase, chasing, chased, catch, crime
verify	verification, verify, verifying, verified, validation
mourn	mourning, memorial, mourn
permit	permit, permission, permitting, privilege, prohibition, phrase, permits
LIKE	
time	time, timeout, timing, timer, timed, this, times, tempo, that, term
sack	sack, strike, sacks, sacked, shutdown
address	address, apology, attack, act, addressing
sacrifice	sacrifice, sacrificing, suicide, sacrifices, sacrificed
duplicate	duplicate, duplication
sponsor	sponsorship, sponsor, sponsoring, support, sponsors
spread	spread, spreading, spreads
assume	assumption, assume, assumed, assuming, assertion, assumptions, assumes
explode	explosion, explosive, exploding, explode, eruption, exploded, earthquake, event, explosions, explodes
slam	slam, smash, slamming, smack, slap, slams, strike, slammed, smashing
dunk	dunk, dive, duck, dun, dip, dump, drowning, diving, dipping
cheer	cheer, cheering, celebration, cheers, cheered, celebrations
divide	divide, division, difference, dividing, definition, divides, disagreement
best	betrayal, bole
warrant	warrant, warrants, worth
dissect	dissect, debate, death
uncover	uncover
seem	statement
resurrect	resurrection, rebirth, revival, resurrect, reboot, resurrected
zip	zip, zipper, zing
air	airing, apology, air, announcement, audible, attack, aired, airs
pour	pour, pouring, pint, poured, phrase
rethink	
approach	approach, attack, approaching, act, argument, aggression, action
wrench	wrench, word, will
investigate	investigation, investigate, incident, inquiry, interrogation, investigative, investigating, interview, it, investigations
crown	crown, ceremony, celebration
iron	it
misuse	misuse, misunderstanding, mistake, mischief, misconduct
ink	ink, illustration, imprint, incident, instance, it
shed	shedding, shed, sacrifice, suicide, sunset, sheds
phone	phone, phrase, peak
fumble	fight, fumble
mix	mix, mixing, mixer, mixture, mixed, mixes, mischief
makes	miracle, mistake, maker, magic, moment, making, mischief
suffice	sacrifice, success
award	award, awarding, awards, achievement, awarded, acknowledgement
tap	tap, tapping, touch, this, taps, tapped, that, touching
advertise	advertisement, advert, ad, advertising, advertise, advertised, announcement, advertisements, ads
determine	decision, date, deadline, dominance, determination, definition, determining, destiny, decisive
retweet	retweet, rt
withstand	war, word, will
explore	exploration, encounter, experiment, explore, exploring, excavation, experience, episode, experimentation, experimenting
dismantle	dismantling, demolition, dismantle, destruction, disruption, damage
visualize	visualization, vision, visual, visualize, visionary, visibility, visuals
boycott	boycott, boycot, blockade, backlash, bds
digest	digestion, digest, diarrhea, defect, delay, dinner, day, disruption
include	inclusion, infinity, it, include, inclusive
argue	argument, argue, arguing, altercation, arguments, argued
preserve	preservation, preserve, preserving, protection
foot	foot, foul, forfeit, feet, footing, fing, food
qualify	qualification, qualifying, qualifier, qualify, qualified, qualifies, qualifications
inject	injection, inject, injecting, insertion, injected, infusion, infection, initiation, it, injections
encounter	encounter, event, experience, encounters
dispute	dispute, disagreement, disputes, disputed, disagree, dissent, disagreements
shine	shine, shining, smile, shines, sunset, success, shone, sun
commit	commit, commitment, crime, committing, committed, confession, commits
MAKE	miracle, magic, meeting, moment, make, mischief
cost	crisis, cost, catastrophe, costs
bang	bang, brawl, banging
appropriate	appropriate, appropriation, adaptation, ape, appropriately, act
implant	implant, implanted, implants, injection, insertion, infection, invention, it, imitation
ring	ring, ringing, rings, rang
chant	chant, chanting, chants, chanted, ching
hail	hail, honor, hour, handshake, herald, hailed, harm, hat
cement	commitment, crisis, conflict, concrete, communication
knew	karma, kill
bar	bar, brawl, ban, boycott, bully, bars, barb, behavior, behaviour
chop	chop, chopping, cut, cutting, clamp, chops, chopped, crime, cuts
fulfill	fulfillment, fulfilled, fulfilling, future, fulfill
gift	gift, giving, gifts, generosity, gif, gesture, give
switch	switch, switching, shift, swap, switched, switches
stain	stain, spill, smear, slur, stains
shorten	shorten, shortened, short, sentence, slang, slavery, shortest, slash
form	forming, formation, fusion, future, form, first
stomach	suicide, stabbing
purchase	purchase, purchasing, price, purchases, payment
hire	hire, hiring, hired, hires
twist	twist, twisting, turn, twisted, trick, this, twists, torture, time
mine	mine, mining, mate, mistake, money, mines
bomb	bomb, bombing, bole, bombings, bombs
salute	salute, such
trademark	trademark, typo, trademarks, term
crank	crank, curse, cobra
done	deed, done, do, did, dinner, death
style	style, styling, statement, styles, styled
boil	boil, boiling, boils, boiled, boiler
gets	genocide
enlarge	event, example, enemy, equality
overlook	overlook
articulate	argument, analogy, adjective, articulate, acronym, ambiguity
pump	pump, pumping, pumps, pumped, pulse, period, pressure
won	war, win, word, will
slip	slip, slipped, slipping, slips, sneak
said	speech, statement
hammer	hammer, hit, hitting, harm
merit	merit, motivation, moment
fall	fall, falling, falls, fell, failure
file	file, filing, ftp, filed, foia, files
clutch	clutch, clutching, contraction, catch
hook	hook, hooks, hooked, hip, how
of	on
chip	chip, chips, cheating, ching
display	display, displaying, demonstration, displays, displayed, day
lost	loss, lost, losses, losing, loses, lose
coach	coaching, coach, challenge, championship
bet	bet, betting, bets
mouth	mouth, mouths
ensure	emergency, event, enemy, example
flash	flash, flashing, flashed, flashes, flashback, flip
possess	possession, possess, possessed, property, possessing, present, possesses
picture	picture, photo, phrase, projection, photograph, painting, pictures, perception
suit	suit, style
lay	lay, laying, laid, lie, lays, lying
sound	sound, speaker, sounds, speech, sounding
organise	organisation, order, organise, organising, organised
reopen	riot, revolution
pinch	pinch, punch, pain, pressure
tip	tip, tipping, tipped, tips, tap, trick, this, theft, term, that
administer	administer, administering, administration, administered, antidote, assistance, anesthesia, aid, age, authority
double	double, doubling, doubles, definition, doubled, dictionary, duplication
rescind	riot, revolution, retaliation
scale	scaling, scale, stride, scaled, step, size, steps
does	deed, damage
heat	heat, heating, heater, heated, hot
strut	speech, strike
agree	agreement, agreed, agree, argument, agreeing, approval, agrees, alliance
snow	snow, snowball, storm, shovel, season
search	search, searches, searching, searched, seo
calculate	calculation, computation, calculator, calculating, calculate, calculated, culation, calculations, ception
grind	grinding, grind, grit
deserves	death, day, days, damage
shovel	shovel, snowball, sidewalk, scrape, snow, situation
activate	activation, activate, alert, activating, action, activated, attack, activates, activity
strengthen	strength, strengthening, strengthen, strike, strong, strengthened, sword
attain	achievement, attack, acquisition, accident, accomplishment, attain
reinvent	revolution, reinvent, revival, renaissance, revolutionary, revolutions
grate	genocide
happen	happen, happens, happening, how
SEE	sighting, see, seeing, sight
generate	generator, generation, generating, generate, genesis, generated
rap	rap, rapper, racism
wonder	word
torch	torch, term, this, threat, that, torches
down	death, defeat, down, damage, downs
visit	visit, visitor, visitation, visiting, visits, vacation, visitors, visited
ID	id, identification, identifier, identity, it, identifying, incident, intelligence, ids
surprise	surprise, shock, surprises, surprising, surprised
rush	rush, rushing, rushed, rushes
debunk	debunk, debunked, denial, disbelief, disagreement
muscle	muscle, murder, moment
condemn	condemnation, crime, censorship, criticism, condemn, condemning
peel	peel, prank, poaching, peach, potato, peeled, process, procedure
starve	starvation, shortage, starving, starve, situation
clinch	conflict, crisis, confrontation, crime
concede	crisis, conflict, confrontation
employ	employment, employee, employer, employ, employed
consume	consumption, consuming, consume
shrink	shrink, shrinking, swelling, shrunk, surgery, size
invite	invitation, invite, inviting, invited, invites, it, invitations
guide	guide, guiding, guidance, guided, guides, goal
poop	poop, poo, prank, period, phrase, po
honour	honour, honor, homage, holiday, hon
fish	fish, fishing, fisherman, fisher
flavor	flavor, flavour, foul, flavors, food
bridge	bridge, bridges, barrier, breach
juice	
convince	convincing, convince, convinced, credibility, case, confidence
wire	wire, wiring, wires, wired
warm	warmth, warm, warming, warmer, welcome, warmed, winter
embarrass	embarrassment, embarrass, embarrassing, event, example, embarrassed, expression
bike	bike, bicycle, biking, bikes, bicycles
bowl	bowl, bowling, brawl, bully, bowls
compose	composition, composing, compose, composer, composed, creativity
graduate	
making	moment, mischief, magic
expand	expansion, exponential, event, effect, example, extension, expectation, expanding, expand
sketch	sketch, sketches, sket
furnish	future
dislike	dislike, disagreement, dispute, disliked, disapproval
preach	preaching, preach, preacher, prophecy, pamphlet, preached, phrase
acquire	acquisition, acquire, acquiring, acquired, appropriation, acquisitions
park	parking, park, problem, phrase, parked, parks, place
in	incident, impact, it, in
prepare	preparation, prepare, prepared, preparing, prep, plan, preparations, present, planning
stone	stone, strike, stones, swearing
authorize	authorization, authorize, authority, authorizing, authorized, approval, act, appropriation, action
rank	ranking, rank, rating, review, reputation, ranked, rankings
stretch	stretch, stretching, stretched, squeeze, strain, stretches
poison	poison, poisoning, plague, phrase, poisoned, poisons
scrub	scrub, scrape, shower, scraping, slap, splash
feather	feather, fight, fighting, flying, feathers, fing
grant	grant, gift, granting, grants, granted, generosity, guarantee, giving, give
tow	tow, tipping, theft, tip, this, term, that, time, towed
bung	breach
will	will, win, willpower, word
shave	shave, shaving, shaved
after	accident, action, attack, act, abuse, animal, assault, aggression
trick	trick, threat, trap, this, tricks, term
doing	day, do, deed, doing, dinner, done
stir	stir, stirring, spring, spark, stirred
confront	confrontation, conflict, crisis, challenge, confront, confronting
assemble	assembly, assemble, assembling, automobile, assembled
comprehend	comprehension, comprehend, communication, concept, conversation, cognition
collapse	collapse, collapsing, cliff, collapses, crash, collapsed, crumbling
bump	bump, bumps, block, bumped
stagger	strike, speech
stitch	stitch, stitching, stitches, sock, sewing, scarf, season
restart	restart, reboot, reset, refresh, recovery
lower	low, lowering, lesson, lower
bank	breach, betrayal, bole
nut	
shift	shift, switch, shifting, shifts, shifted
applaud	applause, applaud, award, appreciation, applauded, audience, amen
liberate	liberation, liberating, liberate, liberated, liberty
dot	dot, doodle, dash, delay, dab, dodge, dots, day, dancing
disable	disabling, disable, disabled, downtime, damage
eradicate	enemy, evil, extermination, epidemic, elimination, end, extinction
overturn	overturn, overthrow, outcome, obstacle
bleed	bleed, bleeding, blood, blister, bloody
issue	issue, issued, issuance, issuing, incident, it, issues
size	size, sizing, sizes, scale, sized
glue	glue, glued, gging
struggle	suicide
unravel	unravel
likes	
mute	mute, malfunction, moment
dress	dress, dressing, day, dresses
empty	empty, emptiness, empt, explosion, event, emptied, end, equivalent
roast	roast, riot, robbery, roasted, racism, retaliation
never	never
pray	prayer, pray, praying, prayers, prayed, phrase, prophecy
HAVE	harm
stuff	slap, situation, smack, stuff, shove, shit, stuffing
KILL	kill, killing, killings
harvest	harvest, harvesting, harm
censor	censorship, censor, coup, control
oversee	order, oversight, official, overseeing
denounce	denouncing, day
just	
regulate	regulation, rule, regulating, regulate, regulatory, regulations
widen	word, war, will
through	threat, this, through, that, term, time
combine	combine, combination, combining, conjunction, combo, combined, coincidence, crossover, coordination, coupling
nailed	
git	git
exceed	excess, expectation, exceed, exponential, edge, event, equality, exceeding
battle	battle, brawl, battles
excuse	excuse, exception, explanation, error, example, exemption, equivalent, excuses
insult	insult, insulting, insults, it
spark	spark, sparking, sparks, start, sparked, signal
steer	steer, steering, situation, steered
OK	ok, order, offense, okay
conclude	crisis, conflict, closure, communication
list	list, listing, lists, listings
has	harm
crest	crisis, conflict
smooth	strike, speech, success, smooth
me	moment
compute	computation, compute, computing, calculation, computed, coincidence, computational, comput, ception
proof	promise, phrase
color	color, coloring, change, colour, colors, colored, cycle
missed	moment
tattoo	tattoo, tattoos, this, term, that, time, ting
hike	hiking, hike, hitch, hikers, h, hikes
ate	attack, argument, accident, act, apocalypse
green	genocide
diffuse	diffuse, diffusion, disturbance, disruption, displacement
mock	mocking, mock, mockery, meme, mischief
slide	slide, slip, sliding, slam, slides, slippery, slime
Make	moment
stroke	stroke, strokes, slap, strike, such
monitor	monitor, monitoring, monitors, measure
brick	brick, bricks, brawl, bole
Tweet	tweet, twitter, tweeting, tweets, typo, term, this, tweeted, that, time
blaze	breach, bole
ponder	problem, phrase, paradox, philosophy, peak
getting	genocide
stock	stock, sale, stocking, surplus, slang, stocks
shit	shit, spat, situation
fuse	fuse, fusion, fit, fused
scan	scan, scanning, scanner, scans, search, seizure, sighting, scanned, screening, surveillance
recycle	recycling, recycle, recycled, reuse
piece	phrase, peak
modify	modification, modify, modifying, modifier, modified, mod, modifications, mutation
water	water, watering, waterfall
locate	locating, location, locate
peg	peg, pegged, prediction, puzzle, proposition, paradox, ping, phrase, peak
heed	harassment, harm
brown	brown, burn, boil, burning, bully, brawl, burns
retract	retract, retaliation, retracted, resistance
over	over, obstacle, offense
squeeze	squeeze, squeezing, shove, squeezed, squee, situation
jam	jam, jammed, jams, jump
obey	obedience, order, obey, obligation, obedient
sip	sip, saliva, spit
muster	moment
gas	gas
stay	stay, shift, staying
stalk	stalking, stalk, situation, surveillance
mash	mash, mashed, mish, meal, mutation, mischief, mark, magic, mixing
adapt	adaptation, adapting, adapt, adaptive, adjustment, adapted, appropriation, adaptations, ability
deflect	deflect, delay, diversion, distraction, dodge, disruption
despise	dislike, despise, disagreement, disdain
bind	bind, binding, bound, bond, bondage, binds, bindings
bit	bite, biting, bitten, bit, bug, bites
redesign	redesign, revolution
reconsider	revolution
slug	slug, slap, strike, slam, slash, spitting, slapping, spit
bolt	bolt, bite, breach, bolts, biting
rest	riot, retaliation, revenge
poke	poke, poking, pinch, poked, prank, prick, punch, push, provocation
bullshit	bullshit, bluff
criticize	criticism, critique, complaint, controversy, critic, criticizing, critical, complaining, criticize, criticisms
clarify	clarification, clarity, clarify, clarified, clear, confusion, contradiction, certainty
cash	cash, check, counterfeit
round	round, roll, rally, retaliation, rounding
stamp	stamp, stamped, stamps, slap, sticker, signature
knows	kill, knowledge, knowing, know
drag	drag, dragging, dragged
fine	fine, fined, fines, fault
throttle	term, this, throttle, takedown, that, threat, time
lend	lend, loan, lent, lending
renew	renewal, renew, renewed
dump	dump, dumping, divorce, date, day, dumps, dumped, days
used	use
plot	plot, plotting, plan, prophecy, prediction, plotted, planning, phrase, plots
increase	increase, improvement, it, inflation, increases
link	link, linking, linkage, linked, links
broadcast	broadcast, broadcasting, broadcaster, broadcasts
sweep	sweep, sweeping, sweeps, swipe, swept
plead	promise, phrase, peak
dish	dish, dinner, dishes, debt
weld	weld, welding, work, will
smear	smear, slander, scandal, slur, sabotage
betray	betrayal, betray, breach, betrayed
buckle	buckle, belt, breach, bribe, brawl
box	box, boxing, brawl, boxes
praise	praise, praising, phrase, praises, performance, positive
complicate	complicate, complication, crisis, conflict, complicated, challenge, confusion, chaos, complications
trace	trace, tracing, trail, track, traced, tracking, tracker, term, this, time
sample	sample, sampling, specimen, stealing, samples, saliva
transmit	transmission, transmitter, transmitting, transmit, transfer, teleportation, transmitted, this, term, transmissions
foresee	foresee, future, forecast
nickname	nickname, name, nick, naming, names
retain	retention, relationship, retain, retaining, retained
pee	pee, poop, piss, prank, period, poo
spawn	spawn, spawning, seed, spawned
temper	temper, tant, threat, this, term
analyse	analysis, analyse, algorithm, analytic, analys, analytical, analyses
threaten	threat, threatening, threatened, threats, threaten, term, this
skate	skate, skating, speed, sk
pardon	pardon, proclamation, pard, phrase
reboot	reboot, restart, reset, recovery
tax	tax, taxation, tariff, theft, taxing, this, taxes, term
dedicate	dedication, dedicate, donation, dedicated, day, devotion, deed, days
discharge	discharge, dispatch, discipline, damage
okay	okay, offense, ok
dim	death, darkness, damage
connect	connection, connect, connecting, connector, connected, catalyst, connectivity, connections, connects, communication
FIX	future
dry	drying, dry, drought, drip, dried, day
ration	riot, revolution, retaliation, revenge, retribution, rage
darn	death, day, damage
at	attack, assault, aggression, act, attempt, anger
weaken	weakening, weakness, weaken, weak, weakened, weaknesses
remedy	remedy
divert	diversion, divert, distraction, delay, diverted, distract, deflect, deviation, direction
bat	bat, batter, baseball, batting, brawl, bats
complement	complement, compliment, complementary, contribution
alter	alteration, alter, action, accident, altering, apocalypse
polish	polish, polished, performance, painting, phrase, paint, period
deem	definition, decision, declaration, discrimination, distinction
contest	challenge, contest, competition
dub	dub, definition, distinction, dubbed, discrimination
game	game, gaming, gambling, games
torpedo	torpedo, threat, tornado, this, term, that
pot	phrase
blend	blending, blend, blended, blends
tough	threat, term, this, time
pound	pound, punch, phrase, pounding, pun, punching, pounds, punishment
silence	silence, shutdown, speech, silent, suppression, sound, situation
piss	piss, pee, pissed, pest, period
conceal	conceal, cloak, cover, concealed, camouflage
spray	spray, spraying, sprayed, splash, spill, situation, shooting
yield	yield, yielding, yielded
if	instance, incident, it, if
bark	bark, barking, bully, brawl
sit	sit, sitting, seat, seating, sits, sat, situation
defy	defiance, disobedience, deviation, dissent, disagreement
wheel	wheel, will
microwave	murder, moment
earned	event, emergency, earthquake, enemy, end
exhibit	exhibit, exhibition, event, example, exhibiting, exhibited, exhibits
commemorate	celebration, ceremony, commemorate
flood	flood, flooding, floods, flooded
panic	panic, panicked
plate	plate, phrase, prank, period, payment, plates
chose	choice, conflict, choosing, chose
dwarf	dwarf, defeat, duel, dominance, domination, damage, death, disruption
communicate	communication, communicating, communicate, conversation, communications, communicated, concept
befriend	befriend, beginning
trump	triumph, term, trump, this
tire	tire, tires, tyre, term, this, time
forfeit	forfeit, forfeiture
combat	combat, conflict, confrontation
STOP	stop, speech, situation
abort	abort, abortion, accident, abortions, aborted
date	date, dating, dates, day, dat, days
Try	threat, term, time, this, that, trust
stage	stage, staging, scene, show, speech
title	title, term, this, that, titles
frost	frost, future, fork
nurse	nurse, nursing, night, nurses
examine	examination, evaluation, exam, examine, examining
integrate	integration, integrate, integrating, interaction, integrated, impact, imilation
tease	tease, teasing, taunt, threat, this, troll, teased, term, that, tick
stream	stream, streaming, streams
signal	signal, signaling, sign, sos, signalling, signaled, signals, signature, symbol
label	label, labeling, labels
crumble	crumble, collapse, crumbling, challenge
bum	brawl, bum, bluff
trim	trim, trimmed, term
pinpoint	pinpoint, phrase, prediction
channel	channel, channels, communication, concept, conversation, conduit
pawn	pawn, payday, payoff, pirate, piracy, period, peak
ignite	ignite, ignition, ignited, it
blew	breach, bole
boot	boot, boycott, ban
pirate	pirate, piracy, pirates, prank, pir
pave	promise, phrase, peak
bully	bully, bullying, boycott, bullies, behavior
accelerate	attack, accident, argument, action, acceleration
overthrow	overthrow
value	value, valuation, valued, values
weave	weaving, weave, woven, wedding, witchcraft, word, web, will, work
envision	event, expression, example, envision
claw	claw, claws, cycle, ching
contemplate	conversation, comment, contemplation, communication
register	register, registration, registering, registry, registered, record, registers, registrations
slaughter	slaughter
whistle	whistle, whist, whisper, whine, word, whispering
market	market, marketing, marketplace, moment, mark
cave	crisis, conflict, confrontation
ready	revolution
distribute	distribution, distributing, distribute, distributed, donation, deed, delivery, distributions, day
extend	extension, extend, extended, extending, entitlement, effect
treat	treat, term, treatment, theft, this
nod	nod, nodding, nods, nodded
hoard	hoard, horde
brake	brake, braking, brakes, block, bicycle
stumble	stumbling, stumble
disappoint	disappointment, disappointing, disappointed, disaster, disappoint, day, dissatisfaction, distress
fixed	future, failure
spur	spur, statement, spark, speech, stimulus
next	
upset	upset, upheaval, upsetting
bleach	bleach, blight, breach
vote	vote, veto, voting, victory, votes
emulate	emulation, example, emulate, equivalent, expression
bash	bash, brawl, bully, boycott, bashing, bullying
dent	dent, damage
prosecute	prosecution, prosecute, prosecuting, prosecutions, penalty, prosecuted
champion	champion, champions, championship, conflict
stunt	stunt, stunts, stalking, sabotage
contact	contact, call, communication, contacting, contacts
breed	breed, breeding, breeds
death	death, days
mastermind	moment, murder
scoop	scoop, snowball, spat, spitting
breach	breach, breaching, breached, breaches, break
gather	gathering, gather, gathers, gathered, gatherings
wax	wax
eclipse	eclipse, event, election, eclips, effect
brush	brush, brushing, brushed, bump, broom, brushes
steel	strike
observe	observation, observer, observing, observe, observed, observable, observes, observational, observations
liked	
sting	sting, std, slap, strike
broke	breach, bole
dispatch	dispatch, death, dispatcher, dispatched, danger
beam	beam, beams, bole
wanted	war, word, will
Get	
accompany	accompanying, assist, appearance, adventure, announcement, accompany, accompanied, assistance
revisit	reunion, retrospective, relationship, revisit, reconciliation
utilize	usage, utilization, use, utility, utilize, user, uses
encrypt	encrypt, encryption, encrypted, exception, equivalent
divine	divine, directive, deity, destiny
fade	flood, future
punish	punishment, penalty, punishments, punish, punishing
decline	decline, dispute, declined, declining
glass	genocide
smile	smile, smiling, smiled, smiles
operate	operation, operator, operations
separate	separation, separating, split, separate, separated, separates
concoct	crisis, conflict
damage	damage, disaster, destruction, damages, destructive, damaging, danger
dab	damage
cloud	cloud, cloudy, clouds, communication
access	access, attack, api, accessing, accessed, authentication
patrol	patrol, patrolling, phrase, patrols, policing, protection
thwart	thwart, threat, treason, this, thwarted
recount	recount, recall, recounts, recollection, reporting
navigate	navigating, navigation, navigate
price	price, profit, purchase, pricing, period, prices, peak
hole	hack, harm
model	model, modeling, modelling, modeled, models, meme, metaphor
prescribe	prescription, prescribing, prescribe, prescribed, procedure, patent, phrase, prescriptions, period
scalp	scalp, stabbing
pair	pairing, pair, partnership, pairs, partner, paired, phrase
maybe	moment, miracle
surface	surface, situation
affect	affect, accident, attack
strip	stripping, strip, strike, situation, sex, sting, strips
free	freedom, free, freeing, future
derive	dependence, due
latch	
imitate	imitation, imitate, it
sand	sand, sandbox, strike, shoe, snowball, storm, slap, sandy
doom	doom, death, disaster, danger, darkness
deed	deed, death, duel, deeds, day
egg	egg, eggs, event, erection, example
showcase	showcase, show, spectacle, showcasing
harness	harness
Do	day, days, death
bad	bad, bully, betrayal
killed	kill, killing, killed, killings
illustrate	illustration, illustrating, illustrate, illustrated, it, illustrates, illustrations
filter	filter, filtering, filters, filtered, feedback
step	step, stepping, steps, strike, situation, stalking, stepped
kid	kid, kidnapping
urge	urge, urging, urges, use, urgency
violate	violation, violating, violate, violated, violations
lease	lease, leasing, llc, loan, leases, leased
is	it, instance, incident, is
key	key, keyword, keys
nurture	nurture, nurturing
sever	sever, strike, severed, sword
enact	event, enactment, enact, effect, expression, enacted
intend	intention, intent, intentional, intended, instance, it, intend, intending, intentions
ingest	ingestion, ingest, infection, incident, ingested, insect, it, intoxication
blur	breach, blocking
prick	prick, pinch, prank, poke, provocation, pain
reform	reform, revolution, revolt, riot, rebellion, reforming, revenge, resistance, reforms
bookmark	bookmark, birthday, book
can	crisis, catastrophe, conflict
spare	sacrifice, saving, spare, sparing
haul	haul, harm, h
hurdle	hurdle, hack, harassment, harm
quite	
realized	revolution, riot
essay	event, essay, example
shop	shop, shopping, sale, season, sales, shops
populate	population, place, phrase, populate, pace
dust	dust, day, dirt
invest	investment, invest, investor, investing, ico, it, investments
highlight	highlight, highlighting, headline, highlights, hashtag
grit	
terminate	termination, terminate, terminating, terminated, term, transition, this, termin, threat, time
script	script, scripting, screenplay, scripted, scripts, sentence, spell, scene
seen	sighting, saw, seeing, sight, seen, see
gasp	
perpetuate	phrase
update	update, upgrade, updates, updating
but	breach, betrayal, behavior
delay	delay, delaying, delayed, delays, deadline, disruption
travel	travel, teleportation, term, time, threat, trip, traveling, this, translation, travels
mess	mess, mischief, mistake, messing, messy, moment, mark
dance	dance, dancing, disco, dances, dancer, danced
dictate	dictate, directive, decision, deadline, decree, domination, dominance
spew	spitting, spew, speech, spit, spat, statement, sentence
manifest	manifest, manifestation, manifested, moment, miracle, manifests, magic
relay	relay, relayed
negotiate	negotiation, negotiating, negotiate, negotiations
dam	damage, death
pedal	promise, phrase, peak
dissolve	dissolution, dissolve, dissolved, disruption, destruction, demolition
withdraw	withdrawal, withdraw, withdrawing, withdrawn, withholding, withdrawals
limit	limit, limitation, limits, limiting, limitations, law
seed	seed, seeds, sow, sex
foster	foster, fostering, fost, future, first
scare	scare, scares, scary
lie	lie, lying, liar, lies, lied
advocate	advocate, advocacy, argument, ally, activist, alliance, advocating, activism, analogy, action
pretend	pretend, pretending, pretended, prank, phrase, play
prize	prize, phrase, prizes
chain	chain, chained, chains, catch
reference	reference, referencing, references
clip	clip, clipping, clipped, cut, cutting, clips, crime
wait	wait, waiting
cough	cough, coughing, curse, choking, cold, contraction, catch
parse	parsing, parse, parser, parsed, phrase, processing, predicate
formulate	future
provoke	provocation, provoke, provoking, provoked, provocative
buck	buck, bully, bluff, brawl, bang, bucks
copyright	copyright, copying, copyrighted, crime
occupy	occupation, occupying, object, occasion, occupy, occupied, occupancy
attend	attendance, attending, attend, assembly, appearance
finger	finger, fingers, fing
wake	wake, waking, warning, woke
tank	tank, term, theft, threat, treason, this, time
place	place, placement, placing, position, parking, placed, positioning, places, pace
suppress	suppression, suppressing, suppress, suppressed, situation
freak	freak, fear, fright
loved	love, loss, loving
headline	headline, headlines, headlined, hashtag
facilitate	facilitating, facilitate, facilitated, future, function
field	field, fielding
draft	draft, drafting, drafts, drafted, deadline, day
ram	riot, ram, retaliation
establish	establish, establishment, event, establishing, established, erection, establishes, ence
amend	amend, amendment, alteration, act, action, agreement, alter, appropriation
eye	eye, eyebrow, ey, encounter, expression, example, eyes
strain	strain, stress, strained, strains, situation
circle	circle, circles, cycle, circling, collision, coincidence, cling, contact
bed	
resemble	resemblance, resemble, resembling, resembles
tape	tape, this, threat, term, taped, torture, technique, time, tapes, tampering
KNOW	knowing, knowledge, know
procure	procure, procurement, purchase, purchasing, phrase, price
compare	comparison, comparing, compare, compliment, competition, comparisons, critique, comparative, competitiveness, criticism
rival	rivalry, rival
skirt	skirt, stalking, shadow, sneaking, skirts, speed
harm	harm
undermine	undermining
void	void, veto, violation, verb, very
favor	favor, favour, favors, friend, fairness, favoring
project	project, projection, projecting, presentation, projected, prediction, prototype, phrase, projects
butter	butter, banquet, bully, behavior
cream	crisis, conflict, crime
crawl	crawl, crawling, crawled, creepy
tried	threat, term, time, this, that
Like	
revoke	revocation, revoke, revoked
advise	advice, advisory, advise, advisor, adviser, advising, advocate, advised, assistance
revise	retaliation, revenge
jail	jail, justice
captain	crisis, conflict
ridicule	ridicule
quote	quote, quotation, quoting, quotes, quotations, quoted
target	threat, target, targeting, term, terrorist, targeted, this, terrorism, threats
finished	future
flag	flag, flags, flagged
matter	moment, meaning, matter
merge	merge, merger, merging, merged
expend	event, emergency, enemy, execution, election
devise	day, deadline, days
ramp	riot, retaliation, revenge, rage
big	bole
flick	flick, flip, flipping, fight, flipped, friction
critique	critique, criticism, critic, crit, complaint, critiques, challenge, criticizing, criticisms, commentary
shade	shade, shading, slur, shadow, smear, slander
rig	rigging, rig, robbery, rigged, riot, raud
sock	sock, slap, sting, socks, situation, stealing
code	code, coding, cod, coded, codes, c
mug	mug, mob, misdemeanor, mark, moment, murder, mischief
overpower	overpower, onslaught, obstacle, overwhelming
off	offense, off, on
amplify	amplification, amplify, amplifier, amplified
half	holocaust, harm
stake	stake, strike, stab, stabbing, stakes, stalking
profess	promise, prophecy, phrase, peak
condone	crime, complicity, condemnation, criminal, charity, coercion, conduct, condone
worship	worship
view	view, viewpoint, vision, viewing, views, viewed
near	nuisance, near
punt	punt, pun, punishment, phrase, penalty
abolish	abolition, anarchy, action, agreement, act, abolish, appropriation, apocalypse
credit	credit, citation, compliment, credits, charity
video	verb, violence, video
stress	stress, stressed, stressing, situation, stressful, stresses
influence	influence, impact, intention, idea, influential, initiative, influencing, influences, it, inspiration
streak	
postpone	phrase, peak
probably	phrase, prediction, probably, probable, probability
fingerprint	fingerprint, fingerprints
scout	scout, scouting, scouts, spy, search, surveillance, spying
invented	it
WIN	word, war, will
disappear	disappearance, disappearing, disappear, delay, disappears, disappeared, day, days
stomp	stomp, strike, step, shoe, spitting, stepping
out	out, outage
tag	tag, tagging, tagged, tags, term, this, tweet, that, threat
reconstruct	reconstruction, reconstruct, reconstructed, replica, rescue, reproduction, restitution, retrieval, recognition
recharge	riot
wrestle	wrestling, wrestle
extract	extraction, extract, escape, extortion, exchange, earthquake, extracting, exploitation
butt	butt, back
contradict	contradiction, conflict, contradict
envy	envy, example, expectation, expression
deepen	day, days, death
exit	exit, escape, end, event, expulsion, eviction, evacuation, exodus, exiting, escaping
shot	shooting, shoot, shot, shootout, shootings
flank	flank, fight, fencing, fing
discount	discount, deficit, discounts, deduction, deal, discrimination, discounted
rob	robbery, robber, riot, robbing, rob, robberies, robbed
spy	spy, spying, surveillance, sighting, spies
remix	remix
mimic	mimic, meme
reproduce	reproduction, reproduce, replication, relationship
root	root, rooting, rooted, relationship, ripple, roots
pilot	phrase, peak
discard	discard, dump, disposal, dumping, day
package	package, packaging, packages, postal, packet, parcel, present, phrase
you	
deal	deal, dealing, dealt, deals, day, deed, debt
shell	shell, shutdown, shelling, shells
satisfy	satisfaction, satisfied, satisfying, satisfy, success, satisfies
source	source, sourcing, supplier, sources, solicitation, supply
raid	raid, raiding, robbery, raids, riot, raided
hitch	harm
hem	harm
scarf	scarf, slap, stabbing, stab, spat
dial	dial
discredit	discredit, defamation, damage
compost	compost, crash, cess
that	that, this, term, time
bloom	bole
so	sacrifice, speech, supper, situation
Read	riot, revolution
shun	shun, situation
frog	frog
chill	chill, chilling, cold, chilled
hawk	hawk, hack, haw
shock	shock, surprise, scare, shocks, shocking, shocked, shaking
triple	threat, term, this, that, time
soak	soak, soaking, shower, sponge, sink, splash, spill
reward	reward, rewards, rewarded, rewarding
moderate	moment
corrupt	corruption, corrupt, corrupted, cheating, crime
isolate	isolation, isolate, injunction, it
worry	worry, worrying, warning, worries
numb	numb
kind	kindness, kind
up	up
foul	foul, fight, felony, fou
though	threat, term, time, this, that
ground	grounding, ground, grounded
confuse	confusion, confusing, confuse, coincidence, confused, communication
sober	sober, suicide
cracked	crisis, conflict, catastrophe
mortgage	moment, murder
blunt	breach, bole
pencil	pencil, prank, phrase, poem, poetry, purple, peak
gust	genocide
outweigh	outweigh, obstacle
crunch	crunch, collision, concussion, crash, choking, ching
inhabit	inhabit, infection, it, immortality
wit	word, war, will
mask	mask, masked, masks
anchor	anchor, anchored, anch, anchors, attachment, alliance, ability
jog	jog
shrug	speech, strike
aid	aid, assist, assistance, ally, aide, act, aiding, assisting
by	breach, bully, behavior
divorce	divorce, dissolution, decree, dispute, divorced, day, date, days
mistake	mistake, misunderstanding, mistakes, mismatch, miss, misconception, mark, mistaken
transport	transport, transportation, transfer, transit, transporting, transporter, taxi, term, trip, time
debut	day, debut, date, deadline, days
illuminate	illumination, illuminating, illuminated, image, it, illuminate
to	threat, this, term, that
fool	fool, fraud, fake, fooled, fools
capitalize	capitalize, compliment, curse, communication, comma, conditional
hum	hum, humming, ho, harm, h
solder	solder
counterfeit	counterfeit, counterfe, ception, cess
BE	breach, betrayal, bole
resume	retaliation
care	care, caring, concern, commitment, cares, cared, compassion
torture	torture, tort, term, threat, this, torment
breakdown	breach, betrayal, bole
swarm	swarm, storm, situation, stalking
overtake	overtake, obstacle
perceive	perception, percept, perceived, perceive, phenomenon, perce, perceptions
pepper	pepper, phrase, proverb, peak, peppers
boost	boost, boosting, booster, benefit, bonus, boosts
state	statement, speech, sentence, state
brand	brand, branding, boycott, branded, brands, bole
too	threat, term, this, time
construct	construct, construction, constructor, creation, constructing, constructed
blown	breach, bole
cycle	cycle, cycling, coincidence, cycles, conflict, circle, crossover, coupling
shotgun	shotgun, shooting, shootout, shoot, shotguns
coordinate	coordinate, coordination, coordinating, coordinated, coordinates, coincidence, cooperation, contingency, communication
pen	pen, poem, pencil, poetry, phrase, pens
upgrade	upgrade, update, upgrading, upgrades
debug	debug, debugging, debugger
steam	steam, sex, stroke, speed
such	
cherry	crisis, conflict, crime
bail	bail, bond, bailed, bribe, bluff
from	future, first
called	crisis, conflict, communication
march	march, marching, murder, mob, moment, marches
cite	citation, cite, cited, citing, citations, credit
transform	transformation, transform, transition, transforming, transformative, term, transformations, time
venture	victory, verb, violence, very
fare	fight, future
swat	swat, slap, smack, strike, slapping
attract	attraction, attract, attracting, attractive, appearance, acquisition, attractiveness, attracts, attention
arm	arm, armed, arming, attack, assist, assault, act, arms, aid, assistance
expel	expulsion, exile, expel, eviction, escape, exclusion, expelled, enclosure, event
cops	crisis, crime, conflict
enhance	enhancement, enhance, enhancing, effect, enhancements, enhanced
thread	thread, this, threat, time, trap, term, that
counteract	counteract, contradiction, coup, crisis, confrontation, combat, counter
uphold	
and	act, agreement, attack, accident, argument, action
charter	charter, contract, covenant, crowdfunding, char
adjust	adjustment, adaptation, adjust, adjusting, adaptive, adjusted, adapting, adjustments
wants	war, word, will
point	point, pointing, pointer, pointed, points, poke, pointers
waterproof	war, word, will
stole	
Skype	skype
grease	grease
compress	compression, coercion, confrontation, compress, crisis, conflict, communication
blank	blank, bluff, block, blocking
forgot	failure, future
without	will
heard	harm
or	on
good	good, generosity
heart	harm
WANT	word, will
subpoena	subpoena, summons, surveillance, subpoen
prolong	promise, phrase
USE	use
mint	moment
disgrace	disgrace, deed, disobedience, day, damage
multiply	multiplication, multiply, multiplier, multiplying, multiplied, money
fulfil	fulfillment, fulfilled, fulfil, future
chart	chart, charts, constellation
undergo	
jerk	jerk, joke, jer
cheat	cheat, cheating, cheated, crime, corruption
anticipate	anticipate, anticipation, anticipated, adaptation, assumption, anticipating, alert
invoke	invocation, invoke, invoking, instance, invoked, it
corner	corner, confrontation, conflict, crime, challenge, corners
READ	riot
author	author, appropriation, accident, alias, authority, authors
conduct	conduct, conducting, confrontation, contact, ception
lap	lap, laps, leap
rise	revolution, riot
craft	craft, crafting, creativity, crafts
image	image, imitation, impression, idea, imagery, it, images, imaging
till	term, threat, time, this, that, trust
slur	slur, slurs, spat, swearing, slander, smear, spitting, spit
table	threat, term, time, this, that, trust
prohibit	prohibition, prohibit, prohibited, prohibiting, prohibitions
train	training, train, term, trainer, this, test, trained, time, that, task
remind	reminder, reminding, recall, remembrance, remind, remembering, reminders, reminded, recollection, remember
staff	speech, staff, situation
resign	revolution, riot, retaliation, revenge, resignation
misinterpret	misinterpret, misunderstanding, mistake, misconception, misuse, misunderstand
pet	pet, pat, phrase, pets, ping
clock	clock, callback, curfew, countdown, clocks
screen	screen, screening, shutdown, screenshot, screens, security, seconds
likely	likely, likelihood, luck
omit	omission, omit, omitted
tan	tan, troll, term, threat, tattoo, this, that, time
eventually	end, ending, event, equality
evaluate	evaluation, evaluate, eval, evaluating, examination, evaluations, evaluated
survived	
coat	coat, coating, coats, costume, coated
disband	day, death, days
overshadow	overshadow, overlap
warn	warning, warn, warnings, warned
blister	breach, bole
cane	crime, crisis
ruined	riot, revolution, revenge
vent	vent
obscure	obscure, obstacle, obstruction, obscurity
drill	drill, drilling, drills, damage, digging
See	
paper	promise, phrase
excise	excise, evil, expression
livestream	livestream, live
exchange	exchange, exchanging, exchanged, exchanges, equivalent
term	term, terminology, title, this, that, terms
refill	riot
tighten	threat, term, this, time, that
prosper	phrase
reign	revolution, riot
oil	
tend	term, tend, time, tending, this, tipping
fan	fan, fandom, f, fans, flight
tread	threat, term, time, this, that, theft, torture
suspend	suspension, suspend, suspending, suspended, strike, suspensions, sentence, situation
law	
manipulate	manipulation, manipulative, manipulating, manipulate
comb	comb, confrontation, curse, conflict, conduct
interrupt	interruption, interrupt, interrupted, incident, interference, inconvenience, interrupts
identity	identity, identifier, identification, id, incident, it, identifying, identities
derail	derail, disruption, disaster, distraction, delay, derailed, destruction, damage
pace	pace, pacing, paced, period
mar	mar, marriage, mark, mating, mischief
slash	slash, slashing, slashed, strike, stabbing, stab, slap, sword
curb	curb, curfew, crime, confrontation, consequence
remain	
palm	palm, phrase, palms
bug	bug, bugs, behavior
lob	lob, lobster, laughter
conceive	conception, conceived, child, conceive, cycle, ception, creation
ad	ad, attack, accident, argument, act, alliance, advertising, aid
man	match, moment, murder, mischief
insure	insurance, insured, insurer, insure, it
appeal	appeal, appealing, attraction, argument, appearance, ape, attractiveness, ability
peak	phrase, peak
tempt	temptation, threat, tempt, trap, tempting, tempted, term, time
render	rendering, render, rendered, renders
vest	victory, verb, violence, very
here	harm
solo	success
speed	speed, speeding, sprint, speedy, speeds
deposit	deposit, deposited, deposits, donation
automate	automation, automate, automated, automatic, algorithm, autonomy
fence	fence, fencing, fight, fences
skew	skew, spoiler
limp	
whiff	word, war
even	event, equal, enemy, end, equality, evil
override	override, overriding, order, opposite
commute	crisis, conflict, communication
inspect	inspection, inspect, inspector, inspecting, inspections, it
finally	future, failure
reduce	reduction, reduce, reducing, reduced, reductions
grace	grace, generosity, gift, gratitude
shutter	shutter, shutdown, silence, sting
scramble	strike
litter	litter
then	threat, term, this, time, that
spam	spam, scam, spoof
prank	prank, phrase, pun, peak
bare	bear, breach, bare
rack	riot, retaliation, revenge, retribution
spite	spite, slander
coax	charm, coercion, coax, cooperation, conditional, contact
cold	crisis, catastrophe, conflict, crime
skill	speech, strike, success
cup	curse, cup, circumcision
proved	phrase
suppose	statement, sentence
disrupt	disruption, disrupt, disruptive, disturbance, disrupting, disruptions, distraction, disrupted, damage
eating	event, emergency, earthquake, enemy, example
mold	mold, mould, modification, mentor, model, modeling, mistake, molded, mark
misunderstand	misunderstanding, misunderstand, mistake, misconception, misinterpret, misunderstood, moment, misinformation
day	day, deadline, date, days, death
elbow	elbow, elbows
harbor	harbor, harbour, hospitality, harassment, harm, hip
really	relationship
tune	tuning, tune, timeout, tap, tuned, this, that, tipping, time, tapping
tally	threat, term, time, this, that
shield	shield, shielding, safeguard, shelter, shields
hurry	hurry, hour, haste, harassment
crushed	crisis, catastrophe, crime, conflict
square	square, squared, squares
started	success
cum	crisis, conflict, catastrophe
rally	rally, rallying, riot, rallies, resistance
balance	balance, balancing, balanced, balances, buffer
select	selection, select, selecting, switch
prioritize	priority, prioritize, preference, precedence, priorit, priorities, performance
took	threat, term, time, this, trust
pan	prank, pan, problem, paradox, phrase, panic, period
aim	aim, arrow, aiming, attack, aimed, accuracy, accident, ambush, arrows
mirror	mirror, mimic, model, mirrored, metaphor, mirrors, matching
bounce	bounce, bouncing, bounces, bump, ball, bounced, behavior
minimize	minimizing, minimize, mitigation, maxim
bid	bid, bidding, bribe, bet, bribery, bidder, bids, bery
configure	configure, configuration, command, config, condition, control
salt	
scent	scent, smell, sniff, smelling, stink, smells, signal
red	riot, revolution, revenge
import	import, immigrant, immigration, invasion, infringement, imitation, imports, importing, it
pause	pause, paused, pauses, phrase
black	bully, black
substitute	substitution, substitute, sacrifice, swap, substitutes, substituted, substit
compromise	compromise, compromising, conflict, crisis, compromises, compromised, compliance
arrive	arrival, accident, appearance, arriving, arrive
feature	feature, features
great	
felt	future
hedge	harassment, harm
managed	moment
eject	eject, expulsion, emergency, ejected, equivalent, event, escalation
discourage	deterrent, discourage, discouraging, deterrence, discouraged
reinforce	reinforcement, reinforcing, reinforced, reinforce, repetition, resistance
compound	compound, contradiction, conflict, coincidence, conjunction, compounded, condition, conditional, cycle, causation
enough	event, emergency, enemy, earthquake, example, end
incorporate	incorporation, integration, imitation, impact, interaction, incorporate, incorporating, incorporated, it, imilation
strap	strap, slap, straps, slavery
infiltrate	infiltration, intrusion, infiltrate, infiltr, intruder, invasion, infiltrated, it, interference
ize	instance, it, i, insult, ization, izing, ize
evade	evade, evasion, escape, escaping, espionage
assure	assurance, agreement, ally, accident, assurances, assistance
triumph	threat, term, time, this
distinguish	difference, distinction, distinguishing, differentiation, distinguish, definition, distinguished
rend	rend, riot, rape, revenge, retribution
ply	promise, phrase
Photoshop	photoshop, prank, phrase, problem, photography, production
impress	impress, impression, it, impressed
bin	bully, behavior
diagnose	diagnosis, diagnostic, disease, diagnoses, disorder, diagnose, days, day
se	
duck	duck, dodge, delay, dunk, duel, ducks
escort	escort, escorted, esc, event, equivalent, enforcement
intensify	it
plaster	plaster, prank, phrase, period
gun	gun, gunfire, guns
morph	morph, mutation, morp, modification, magic
wrote	war, word, will
Buy	betrayal, bole
shower	shower, showers, storm
hog	hog, hack, harassment, hacking
actually	act, action, actor, adaptation, actual, appearance, actually, actions
real	riot, revolution
scorn	scorn, slur, satire
into	interaction, impact, intersection, incident, it
weep	weep, weeping
greet	greeting, greet, goodbye, greets
dock	dock, docking, dispute, damage
ha	harm
punk	phrase, peak
shame	shame, shaming
loves	love, loving, loves, loved, lover
fruit	failure, future
undertake	
impose	imposition, injunction, imposed, imposing, impose, it
rate	rating, review, rate, ranking, ratings, recognition
hop	harm
exercise	exercise, exercising, event, ercise, experiment, exercises, exercised
vow	victory, verb, violence
sanction	sanction, sanctions, suspension, sanctioned
assert	assert, assertion, asserting, argument, aggression, accusation, asserted, assault, asserts
bought	bole
bypass	bypass, breach, betrayal, bluff
audit	audit, auditor, audits, aud, act, accountability, assurance
schedule	schedule, scheduling, scheduled, schedules
discern	discern, detection
transplant	transplant, term, this, transition, time, transfer, that
named	noun
tidy	tidy, this, task, term, time, that
dash	dash, dashed, danger, death
convict	conviction, crime, case, convict, charge, convicted, convictions
avert	attack, accident, argument, act, action, apocalypse
only	outcome
toe	threat, term, this, time, trust, that
calm	calm, calming, crisis, chill, control, cooling
estimate	estimate, estimation, estimated, error, estimating, expectation, estimates, equivalent
evolve	evolution, evolve, evolutionary, example, experiment, event, effect, evolving, evolves, evolved
disarm	disarm, delay, deterrence, deed, danger, damage
tee	threat, term, time, this
simplify	simplify, simplicity, simplified, simple, solution, simpl, simpler
now	
itch	itch, itching, irritation, insect, infection, it
string	string, stalking, stealing, sex, sentence
OWN	
slate	
blows	breach, betrayal, bomb
using	use, usage, using
contract	contract, contracting, contractual, contraction, contracted, contracts, clause
brain	bole
bunk	betrayal, breach, bole
breath	breath, breathing, breathe, breaths
stem	success
transfer	transfer, transferring, transition, transfers, transaction, transmission, transferred, this, transit, term
purge	purge, phrase
quantify	quantify, quote, quant, quantitative
slim	strike
caught	crisis, conflict, crime, catastrophe
assess	assessment, assess, analysis, assessing, appraisal, assessments
hone	
act	act, action, acting, actor, appearance, acts, actions
grip	grip, grab, grasp, gripping, grabbing, grasping, gesture
lump	lump, lawsuit, latter
reply	reply, response, retaliation, responding, respond, replies
hashtag	hashtag, harassment, hack
teleport	teleport, teleportation, this, term, transfer, tele, that, time, transition, transmission
reuse	reuse, reused, recycling, reusable, reproduction, repetition
scoff	speech
dope	dope, drug, dui, deal, dea, day, doping, drugs
short	short, shortage, shortfall, shortest, shorter, situation, shorts
edge	edge, event, example, edged
paste	paste, phrase, poem
idea	it
gum	gum
negate	negate, neutrality, null, negative
graffiti	genocide
testify	threat, term, trust, time, this
filibuster	future
mentioned	meeting, moment
sigh	speech
spear	spear, stabbing, stab, spears, slashing
net	net
educate	education, educator, event, example, educational, educate, enlightenment, election, educating
later	
clue	clue, clues, conversation, coincidence, communication, contact, code
replay	replay, riot, reinforcement, retaliation, retribution
able	attack, argument, accident, act, apocalypse
leg	
him	hat, help, harm
frequent	friendship, frequent, frequency
cultivate	cultivation, cultivate, crop, cycle, cultivating, cultivated
propel	propulsion, propel, projectile, propelled, power
wearing	word, war, will
awake	awakening, alarm, awake, alert, awaken, awakened
jar	jar, jars
cuff	cuff, crime, citation, coercion, conduct
Eat	event, enemy, emergency, example, execution
ve	victory, verb, violence, very
first	future, first
sprint	suicide
garner	gift, generosity
leverage	leverage, leveraging
total	threat, term, time, this, that
ruins	riot, revolution, revenge
prompt	prompt, prompting, provocation, prompted, prompts, phrase
wander	word, wandering, will
age	age, aging, anniversary, ageing, aged, adult, advance, ages
reset	reset, reboot, reconciliation
broaden	bole
line	line, lining, lines, law
wage	wage, war, will
phase	phase, problem, phases, period, phrase, phenomenon
Find	fight, future
export	export, exporting, exports, exchange, exported, exile, example, expression, equivalent
splash	splash, spill, slap, shower, spray, spraying
ding	ding, delay, dat
friend	friend, friendship, friends, friendly, favor, friendships
spice	success
still	
rear	rear, rape, retaliation
cage	cage, crime, catch, communication
fault	fault, failure, fine, faults, failing
ever	event, end, ending, example, equality
invade	invasion, intrusion, intruder, invading, invade, invaded, it, invaders, interference
broken	breach, betrayal, bole
penetrate	penetration, penetrating, penetrated, penetrate, piercing
distract	distraction, distract, diversion, distracting, distracted, distractions, delay, disruption
goddamn	
map	map, mapping, maps, mapped, marker, mark
stack	stack, stacking, stacks, snowball, stacked, situation
attach	attach, attachment, attaching, attached, adhesive, accessory, anchor, abduction, achment, attaches
comp	crime, conflict, contract, challenge, coup, coercion, comp, communication
humor	humor, humour, humorous
reckon	retaliation, retribution
troll	troll, trolling, term, tweet, trolls, this, threat, taunt, that, twitter
herald	herald, honor
t	t, threat, taunt, this, timeout, term, that, threatening, time
flame	flame, fireball, fire, flaming, fuse, flames
exclaim	event, example, eclipse, expression
stump	stump, slap
sandwich	sandwich, slap, sandwiches
interview	interview, interviewer, investigation, it, interviews, interviewing
joke	joke, joking, jokes, joked
fashion	fashion, future, fashionable
prime	prime, payoff, period, performance, phrase, procedure, peak
truck	threat, term, theft, this, time, that
archive	archive, archives, appropriation, artifact, action, archived
house	house, home, housing, household, houses, hospitality, hosting, holiday, hip
blitz	breach, bole
soil	soil, spill, situation
pledge	pledge, pledging, promise, pledges, pledged, phrase
customize	customization, customize, custom, customizable, customized, customer
appoint	appointment, appoint, administration, appropriation, appointing, appointments, appointed, authority
am	attack, accident, argument, act, aggression
father	father, flood, future, fathers
elevate	example, event, elevation, election, elevate
parade	parade, procession, prank, party, pride, poem, performance, phrase, pomp
apprehend	apprehension, arrest, apprehend, apprehended, act, abduction, action
chair	crisis, conflict, crime, confrontation
flesh	fight, future
booze	breach, betrayal, bole
sequence	sequence, sequencing, synchronization
withhold	withholding, withhold, withheld
wound	wound, wounding, wounded
finds	future
specify	statement, specification, specifying, specify, specified, specificity
escalate	escalation, escalate, escalating, example, escalated
massacre	massacre, murder, murders, massacres
says	statement, saying, speech, say, said, sentence
horde	harm
life	
rifle	rifle, riot, rampage, retaliation, rage
bitch	bitch, bully, bitterness, behavior
belt	belt, brawl, buckle, beating, belts, biting
compliment	compliment, compliments, comment, criticism, comments, credit, courtesy
fret	failure, future
built	bole
weight	weight, weigh, weights, weighing, word
believed	breach, bole
relate	relationship, relate, relating, relation, reference, related, relates
unite	unity, unification, union, unite
long	
hard	harm
affirm	affirmation, affirm, agreement, affirmative, assertion, act, activation, affirmed
us	
floor	fight, future
fax	fax
board	boarding, board, budget, bribe, boarded, boards
camouflage	camouflage, cloak, cover, costume
roof	riot, revolution, revenge, retaliation
losing	loss, losing, losses, lost, lose
writing	word, war, will
word	word, words
redirect	redirect, redirected, referral, request, retweet, routing
sees	seeing, sighting, sight, situation, see
lodge	
SIGN	speech
commission	commission, contract, commissions, commissioned, communication
mother	moment, murder
might	moment, mischief
fracture	fracture, fracturing, fall, fractured, fractures, fault
tone	tone, this, temper, threat, term, that, time
dive	dive, dunk, diving, dives, drop, damage, death
behind	breach, betrayal, bole
breeze	breach, bole
vape	vape, vaping, verb, vapor
offset	offset, outcome, offsets, opposite
equate	equivalent, example, equation, equate
mentor	mentor, ment, mentors
brainstorm	bole
embed	embed, embedded, echo, example, exile
feast	fight, future
improv	it
loan	loan, lend, lending, lent, loans
delegate	delegate, delegation, delegated, directive, discretion, delegates
exist	event, existence, end, eternity, exist
luck	
cull	crisis, conflict, coup
blackmail	blackmail, breach
strength	strike, success
instruct	instruction, instruct, instructional, instance, interpreter, it, instructed, instructions
stolen	
having	harm
designed	day, death, days
ticket	threat, ticket, this, term, tickets, that, time
reload	reload, retaliation
assault	assault, attack, act, altercation, abuse, aggression, assaults
rep	rep, reputation, revenge, retaliation
transcend	transcend, transformation, transition, term, time, this
nominate	nomination, nominating, nominee, nominate, nominations, nominated
humble	humility, humble, honor, humiliation, handshake
trail	trail, threat, trap, tracking, time, this, theft, term
motivate	motivation, motivating, motivate, motivated, motivational, motiv, motive, mantra
pulp	phrase
thumb	threat, term, this, thumb, that, tipping, timeout, time
forecast	future
assign	assignment, assign, assigned, assigning, alias, allocation, attribute, appropriation, assigns, authority
this	this, term, that, time, today, times
hated	harm
dip	dip, dipping, dunk, dipped, drop, dips
rebound	riot, revenge
lean	
against	attack, assault, act, aggression, abuse, action
level	level, leveling, ladder, leveled, levels
bus	breach, bole
sub	sub, sacrifice
button	button, buttons
sweet	success
wine	word, war, will
bundle	breach, bole
insist	injunction, instance, insult, it
all	accident, adaptation, ally, action
please	pleasure, please, pleasing, party, phrase
cease	crisis, conflict, catastrophe
pad	phrase
staunch	
rupture	rupture
needing	
effect	effect, event, effects, events
deport	deportation, deport, deadline, deported, detention, day, days
consult	consult, consultation, consulting, conversation, call, communication, consultations, consulted
known	
behave	behavior, behaviour, behave, behaving, behaved, behaviors
knife	knife, knives, kill
knee	kill
was	war, win, will
expense	emergency, event, example, enemy, earthquake
axe	axe, attack, assault, ax, accident, ambush, axes
drug	drug, drugs, dui, dope, dea, doping, disease
tick	tick, trick, this, tease, ticking, taunt, ticks, that, time
regretted	riot, revolution
accommodate	accommodation, agreement, accommodating, adaptation, arrangement, accommodate, amen, accommodations, ability, acceptance
because	
attest	attack, argument, agreement, accident, act
elect	election, emergency, elections, elected
warp	warp, warped, witch, will
echo	echo, echoing, example, echoes, effect, echoed, expression
takes	threat, term, time, this
magic	moment, magic
home	harm
relocate	relocation, relocate, riot
yet	
as	act, action, agreement, as, attack
dice	dice, duel, death, die, damage
case	coincidence, case, crime, conflict, conditional, contact, communication
wolf	word, war, will
legal	
thrive	threat, term, time, this
emit	emission, emit, emitted, emissions, emitting, effect, echo, explosion, event, emits
