die	death, die, day, dying, deed, dead, deaths, dies
win	win, wins, winner, winning, war
be	body, blasphemy
survive	survival, success, surplus, survive, suicide, surviving, sacrifice
fail	failure, fail, failing, failures, fault, failed, first
succeed	success, successes, successful, sacrifice
live	life, living, lifetime, live, lifespan
pass	pass, passing, passed, passes, passage, predicate, process, passive
do	do, deed, doing, done, did, does
cry	cry, crying, crisis, cries, cycle
know	knowledge, know, knowing
fall	fall, failure, falling, falls, first
work	work, workshop, working, writing
leave	leave, leaving, latter
not	null
come	coming, come, conversion, convergence, convert
return	return, reconciliation, restitution, result, restoration, refund, recovery, repayment, returns, redemption
lose	loss, losses, latter, losing, lose, law, lessness
stay	stay, separation, shift, split, state, sleep, staying, stays
bite	bite, biting, bug, bites, breach, behavior, body
tell	tell, telling, time, transition, tale, testimony, term
answer	answer, argument, act, action, affirmative, a, agreement, answers
try	try, time, tries, test, trying
explode	explosion, event, explosive, exploding, explode, execution, exception, example
disappear	disappearance, deletion, day, definition, deed, death
go	go
fly	fly, flight, flying, following, first, fishing
happen	how, h
help	help, helper, helping, helps, helpers
run	run, runtime, running, runner, race, riot, runs
respond	response, reaction, reply, responses, result, respond, responding, riot, retaliation, resistance
sue	suit, sue, suing, same, suits
change	change, changes
remember	remembrance, recall, remembering, remember, recollection, record, reminder, recognition
last	lifetime, last, law, life, latter
too	term, time, tree, tuple, times
eat	event, eating, eat, episode, example, eater
have	have, hold, hip, how
listen	listen, listening, listener, latter, loop
pay	payment, pay, payments, period
miss	miss, missing, mistake, mismatch, misses, missed, misunderstanding, murder
understand	understanding, understand, understood, unity
retire	retirement, retire, retiring, retired, resignation, rule
suffer	suffering, sin, suicide, situation
see	see, seeing, sight, saw, sign, sum, session
talk	talk, time, talking, term
recover	recovery, recover, rebound, restoration, recovering, return, recovered, reconciliation, religion, restitution
starve	surplus, scarcity, shutdown, starvation, suicide, situation, suffering
learn	learning, learn, lesson, learned, latter
say	statement, say, saying, speech, sum, sin, state
wait	wait, waiting, while, watch, waits
stop	stop, shutdown, stopping, stops
scream	scream, screaming, shout, screams, sound, shouting, speech
remain	remainder, residual, rebellion, remaining, riot, religion, resistance
finish	finish, finishing, final, finished
rise	revolution, rise, rebellion, revolt, rising, resistance
break	break, breakdown, breakup, block, breaking, breaks, breach, broken, body, boycott
follow	follow, following, function, first, follower, follows
quit	quit, quitting
lie	lie, lying, lies, latter
disagree	disagreement, dispute, divergence, disagree, dissent, division, discord, difference
graduate	graduation, graduate
burn	burn, burning, burns, blackout, burned, burnt
end	end, ending, endpoint, execution, exit, exception, entity, expulsion, expiration, e
laugh	laugh, laughter, laughing, laughs, latter
strike	strike, strikes, shutdown, striking
smile	smile, smiling, smiles, success
hurt	harm, hurt, hit
call	call, callback, caller, calling, calls, collection, communication, conversation
walk	walk, walking, walks
deliver	delivery, deliver, day, deed, debt
ask	ask, act, asking, answer, argument, action, appropriation, asked
prevail	plurality, paradox, protest
stick	stick, sticks, slap, smack, spear, strike
sleep	sleep, state, sleeping, shutdown
apologize	apology, act, agreement, attribution, appropriation, action, acceptance, apologies, apologizing, apologize
explain	explanation, example, equation, event, expression, entity
kill	kill, killing, kills, killings
perish	
write	writing, write, work, word, will
vomit	vomiting, vomit, virus, verb
speak	speech, statement, speaking, sentence, speak, speaker, sum, second
fold	fold, folding, flow, fork, form, folds, folded, function, former, first
agree	agreement, act, alliance, argument, association, accord, agreed, agree, alignment, appropriation
drown	drowning, disaster, death, day, deed
suffice	surplus, state, subclass
care	care, caring, concern, cure, cares, compassion, collective, condition, context
resign	resignation, resign, rebellion, retreat, revolt, reform
exist	entity, existence, exists, ecosystem, element, expression, entities, enactment
teach	teaching, term, teacher, time, teach, times, taught
never	
testify	testimony, trial, testifying, term, testify, treason
collapse	collapse, crisis, crash, cluster, catastrophe, collapses, chaos
vanish	void, vanish, vanishing, verb
protest	protest, protesting, protests
decide	decision, dispute, default, deed, decisions
triumph	triumph, term
sing	song, singing, solo, sing, songs, spectrum, service, singer
stand	stand, standing, state, statement, sum, speech, support
rest	rest, relaxation, retreat, resting, remainder
count	count, counting, collection, counts, census, computation, calculation
drink	drinking, drink, day, drunk, dui, drinks
continue	continuation, crime, cycle, conversion, corruption, coercion, continuity
crash	crash, crashes, collision, crisis, crashing
escape	escape, exception, exit, exile, event, exodus, escaping, end, escapes
fight	fight, fighting, fights, first
heal	healing, heal, healed, healer, health, heals, help
blink	blink, blinking, blur, body, blindness
soon	suicide, state
show	show, shows, spectacle, stage, state, session, sum
refuse	refusal, refuse, rejection, rebellion, recycling, resistance, refusing
choose	choice, choose, choosing, choices
move	move, movement, moving, motion, migration, moves, movements
watch	watch, watches, watching, watched, work, witness, warning
shine	shine, shining, star, success, shower, sun, smile
matter	matter, mathematics, magic, matters, moment
think	thought, think, thinking, term, thinker, time
now	now
emerge	entity, event, emergence, execution, epoch, ecosystem, explosion
grow	growth, grow, growing, garden
visit	visit, visitor, visits, visitation, visiting, visitors, visited, vacation
play	play, performance, protest, poem, poetry, phase, pace
fit	fit, function, fitting, fits
suck	suck, sucking, sucks, sucker, slur
burst	burst, bubble, break, bursting, block, breakout, breach, bursts, boom, blast
notice	notice, notification, noticing, nuisance
fade	fade, fading, former, flow, fades
bleed	bleed, bleeding, breach, blood, body
again	act, appropriation, attempt, action, argument
share	share, sharing, shared, sum, same
arrive	act, action, argument, appropriation, attack, arrival, abortion, addition
anyway	act, appropriation, action, argument, assault, array, aggregate, above
cave	cave, crisis, collapse, compromise, caves, condition, cult, cat, carving
weep	weep, weeping, witchcraft
rebel	rebellion, revolt, riot, revolution, rebel, resistance, rebels
bail	bail, bond, bailout, bubble, bb
forget	forget, forgetting, failure, former, following, forgot, first, forgiveness
read	reading, read, reader, reads, result, review
bolt	bolt, block, bug, breach, binding, bite
retaliate	retaliation, riot, reaction, response, retribution
reply	reply, response, responses, replies, reaction, result, responding, return
crack	crack, cracking, crash, crime, cocaine, crisis, corruption
rule	rule, revolution, ruling, rules
resist	resistance, rebellion, resist, revolt, riot, resisting, revolution
appear	act, action, argument, appearance, appropriation
appeal	appeal, argument, action, award, application, appeals, above
disappoint	disappointment, disaster, deed
me	man, me
freeze	freeze, freezing, freezes, failure, first, frost
pop	pop, parody, popping, popup, party, peak, pace, phenomenon, pops
sell	sale, selling, split, sell, sales, separation, solicitation, seller
shoot	shooting, shoot, shot, shooter, shootout, shoots, second, shots
eventually	execution, entity, event, exception, end
pray	prayer, praying, pray, prayers, prayed, phrase, practice, process
drive	driving, drive, driver, day, desire, distraction, drives
take	take, theft, taking, term, time, trade, transformation, transaction
land	land, law, legislation, latter, lot, landing
complain	complaint, complaining, complain, conflict, complaints, criticism, case
thrive	term, terrorism
struggle	struggle, strike, split, situation, suffering, struggles
start	start, startup, state, stop
stink	stink, smell, situation, smells, smoking
turn	turn, transformation, turning, transition, turns, time, term
comply	compliance, compliant, compromise, cooperation, covenant, crime, comply, coercion
lead	leadership, lead, leader, latter, leading
succumb	suicide, suffering
hope	hope, hypothesis, hopes, holocaust
ever	event, entity, epoch, existence, example, exception, entities
expire	expiration, end, extension, exception, exit, event, expire, expired, exile, expression
hit	hit, hits, hitting, harm
choke	choke, choking, crisis, crash, ching, crime, coercion, condition, corruption
persist	persistence, protest, problem, paradox, pace, persistent, persist, period
vote	vote, voting, veto, votes
make	make, making, mark, maker, manufacture
confess	confession, confess, conversion, crime, confessions, closure, corruption, case
snap	snap, snapping, snapshot, split, snapped, slap, shot, snaps
evolve	evolution, epoch, exponential, emergence, expansion, event, era, example
match	match, matching, matches, matched, mismatch
approve	approval, act, appropriation, agreement, authorization, action, amendment, approving, agency, approve
give	gift, give, giving, given, grant, generosity, gives
melt	melt, melting, meltdown, moment, melts, making
endure	end, eternity, era, epoch, event, enduring, execution
marry	marriage, merger, marriages, marry, marrying
crumble	collapse, crisis, crumble, curse, construction, cracking, construct
decline	decline, depression, death, downturn, down, depletion, disease, deterioration, decrease
always	always, act, action, array, agreement, argument, absolute
publish	publication, publish, publishing, post, pace, period, publications
serve	service, serving, serve, sacrifice, servant, services, serves
manage	management, murder, managing
tweet	tweet, tweets, tweeting, trend, time, term, timeline, twitter, threat
close	closure, close, closing, closures, confession, collaboration
march	march, marching, marches, movement, moment
though	term, time, theft, tuple, times, tree
hear	hearing, heard, hear, h, hold, how
someday	suicide, sum, sacrifice
react	reaction, response, react, riot, result, retaliation
sign	sign, signature, signing, statement, symbol, speech, signs
look	look, looks, lookup, looking, latter
kiss	kiss, kissing, kisses, kissed
intervene	intervention, incident, intervening, interference, interaction, injunction, invocation, intervene, ing
ride	riding, ride, rides, rider
perform	performance, play, perform, performing, processing, predicate, performer
obey	order, obey, obedience, ordering, ordinance, offense, orem, oning
hold	hold, holding, holds, holder
settle	settlement, settling, settle
revolt	revolt, rebellion, revolution, riot, resistance, revolutions
drop	drop, dropping, dump, drops, down
join	join, joining, joins, joined
slip	slip, slipped, slipping, slide, slips
attack	attack, assault, assassination, ambush, act, aggression, attacker, attacked, attacks
believe	belief, believe, believing, believer, believed, beliefs, bel, believes
travel	travel, trip, traveling, time, tourism, travelling, tour, transit, transportation, transport
attend	act, attendance, action, appropriation, argument, assault, arrest, assembly, attending, attend
sink	sink, sinking, sacrifice, sin
improve	improvement, increase, improved, innovation, improving, injunction, improvements, invocation, individual, ism
argue	argument, act, agreement, arguing, altercation, action, appropriation, assault, abortion, attack
guess	guess, guessing, guesses, game, guessed
reconsider	retreat, review, riot, rebellion, religion
cook	cooking, cook, chef, cuisine, cooks, culinary
please	party, please, petition, prayer, predicate, pleasure
worry	worry, worrying, warning, worries
object	object, objects
qualify	quality
post	post, posting, posts, poster, protest, process
judge	judgment, judge, judgement, judging, justice, jury, judgments
volunteer	volunteering, volunteer, volunteers
erupt	eruption, explosion, event, explosive, eclipse, earthquake, execution, events
mourn	mourning, mourn, murder, moment
next	next, node
relapse	relapse, regression, remission, recovery, repeat, rebound
rock	rock, riot, rocks
faint	faint, famine, former, following
cooperate	cooperative, cooperation, collaboration, consensus, compromise, coordination, convergence, cooperate, ceasefire, cooper
nap	nap, night
propose	proposal, predicate, propose, proposed, protest, petition, place, plan, proposals, pace
get	get, grab, getting, gift, give, good
convert	conversion, convert, conversions, converting, converts, converted, change, christianity
yield	yield, yielding, yields
benefit	benefit, benefits, body
regret	regret, remorse, regrets, repentance, recession, retrospective, rage
act	act, action, attack, argument, accusation, actor, acting, actions, acts
fry	fry, frying, fried, fine, flood, famine, fish, fishing, food
pee	pee, poop, piss, problem, procedure, penis, process, period, plumbing, privacy
flee	fleeing, flight, flee, famine, felony, former
comment	comment, comments, criticism, critique, commentary, commenting, condition
flip	flip, flipping, fork, flipped, flow, flips
confirm	confirmation, consensus, confirm, crime, conversion, confession, confirmed, check, circumcision, case
ship	ship, shipping, sailing, sale, sail, shift, shipment, ships
bloom	bloom, bubble, bud, biology, body, beauty
mind	mind, meditation, mindset, motive, moment
adapt	adaptation, act, adjustment, adaptive, action, appropriation, attack, argument, ability
yet	
fire	fire, fireball, flame, fires, fuse, firing, first
dance	dance, dancing, dances
compete	competition, contest, conflict, challenge, competitions, competitor, cheating
shout	shout, shouting, scream, shouts, screaming, speech, sound, swearing
report	report, reporting, review, reports, reported
wonder	wonder, work
bomb	bomb, bombing, breach, bang, burst, bombs, blast, bomber, body, bombings
pull	pull, pulling, push, pulls, process, pressure
bounce	bounce, bubble, bouncing, bounces, bump, body, bb, ball, back
save	save, saving, saves, sum, sacrifice, snapshot, state, salvation, saved
dominate	dominance, domination, dominant, dominating, dominate, deed
buy	buy, buying
blow	blow, blows, blackout, burst, breakup, body, blowing, burn
belong	body
hang	hang, hanging, hangs, hung, h, homicide, hat
accept	acceptance, act, agreement, accepting, accept, action, apology, appropriation, argument, adoption
sting	sting, strike, spat, slowdown, second
shrink	shrink, slowdown, shift, shrinking, size, second, sis
slide	slide, slip, sliding, slides, slope, stack
participate	participation, party, participant, protest, participate, process, progress, play, participating
meet	meeting, meet, merger, match, marriage, murder, manship
spread	spread, spreading, swarm, split
you	
jump	jump, jumping, jumper, jumps
insist	insistence, inconsistency, insurrection, istence
leak	leak, leaking, leakage, leaks, latter, load
rot	rot, rotation, rape
rebuild	rebuild, rebuilding, reconstruction, restoration, recovery, reboot, renovation, restore, restart, revival
check	check, checking, checks, correction, checked, condition, case
occur	offense, occurrence, omaly, overlap, oning
cease	cessation, cease, closure, ceasefire, conduct
apply	act, argument, action, appropriation, aggregate, above
panic	panic, psychosis
keep	keeping, keep
find	find, finding, finds, function, first
pick	pick, picking, preference, pickup, process, possession
bark	bark, barking, bite, banana, behavior, body, baking
tomorrow	time, tomorrow, things, term, tree, tuple, times, transaction
today	time, term, tree
connect	connection, connect, chain, cluster, connecting, coupling, connectivity, connections, connector
linger	limbo, latter, lingering, law
hesitate	hesitation, homicide, holocaust
admit	admission, act, appropriation, assault, action, abortion, admitting, agreement, admit, arrest
surrender	surrender, sacrifice, secession, split
smoke	smoke, smoking, second
arise	act, action, appropriation, abortion, argument, attack, assassination, association, aggregate
tonight	time, tree, term, tonight, transaction, times
indeed	instance, invocation, integral, instances
feast	feast, festival, famine, fasting, first, festivals, fast, food
bitch	bitch, boycott, body, backlash, behavior, bully
release	release, releases, rebellion, releasing, runtime
bake	bake, baking, baked, bakery, baker, body
pitch	pitch, pitching, pitches, phase, pitcher, process, pitched, ping, phrase
prosper	profit, prosperity, progress, period, protest, poverty
swear	swear, swearing, sin, sign, stealing
blog	blog, blogging, blogs, blogger
contribute	contribution, contributor, contributions, collection, contributing, corpus, contribute, charity, communism
yell	yell, yelling
promise	promise, pledge, promises, proposal, promised, prediction, predicate, promising
sit	space, state, seat, sit, sitting, sum, sacrament
shave	shave, shaving
adjust	adjustment, act, appropriation, action, anomaly, arrest, attack, adjusting, adjustments
fuck	fuck, fucking, first
shatter	shatter, split, shattering
Die	die, death, deed, day
dream	dream, dreaming, dreams, delusion, day
execute	execution, execute, executing, event, executed, exception, executes, executions
elaborate	execution, exponential, example, event
right	right, rights, result, row
out	out, outage, offset, opposite
behave	behavior, behaviour, bug, body
maybe	maybe
destroy	destruction, destroy, deletion, destroyed, damage, disruption, death, deed
swallow	swallow, swallowing, spill, spat
rain	rain, rainfall, rainbow
test	test, testing, tests, time, times, true
knock	knock, knocking, knocks
rally	rally, riot, rise, rebound, rallying, rebellion, rallies, result, reaction
regress	regression, regress, reverse
prove	proof, predicate, prove, proofs, proving
buckle	buckle, bottleneck, bind, block, belt, body, buck, binding, bracelet
suit	suit, strike, same, suits, sum, state, success
hide	hide, hiding, hidden, hid, hides
then	then, term, tuple, time, thing, times, tree
study	study, scholarship, science, studies, synthesis, subject, session, sum
swim	swim, swimming, stroke, sacrifice, suicide, surfing
inherit	inheritance, instance, inherit, injunction, invocation, index
reign	rebellion, rule, reign, revolution, revolt
regenerate	regeneration, resurrection, revival, recovery, reboot, restoration, rebirth, reset, return, redemption
retweet	retweet
clarify	clarification, clarity, clarify, clear, crime, consensus, comma, confusion, conversion, context
cross	cross, crossing, collision, conflict, crucifix, crosses, conversion, crime, circumcision, change
submit	submission, submit, submitting, sacrifice, submissions, sum, submitted
beg	beg, begging, bounty, bribe, bargain, body, binding
need	need, necessity, needs
whine	whine, whining, word, wine
relent	retreat, riot, revolt, rape, rebellion, resistance, rest, result
donate	donation, donating, donate, donations, deed
later	latter, law, legislation
exit	exit, escape, end, exception, exodus, event, entry, exile, empty, expulsion
draw	drawing, draw, draws, drawings, design, draft, drawn
investigate	investigation, incident, investigate, instance, investigating, inquiry, investigations
click	click, clicking, clicks, connection, cursor, command
himself	
beat	beating, beat, beats, break
celebrate	celebration, celebrating, celebrations, celebrate, carnival, crime, celebrated, circumcision, conversion
surprise	surprise, shock, surprises, surprising, surprised
depart	departure, deletion, day, deed
wake	wake, waking, work
spill	spill, spilling, spills
soar	success, sky, suicide, sacrifice
cheat	cheating, cheat, corruption, crime
point	point, pointer, pointing, points, pivot, place, process
open	open, opening, openness, object, opener, oning
cope	crisis, coping, crime
wander	wandering, wander, where, walk, wake, will
probably	protest, predicate, pair, pace
begin	beginning, body
repeat	repeat, repetition, replication, return, reuse, replay, repeats, ritual
kick	kick, kicking, kicks, kicker, kicked, knockout, kill
freak	freak, first, fraud, ference
tire	tire, time, term, theft
enter	entry, enter, entrance, event, entering, exception, exit, entity, end, entries
forever	future, forever, function, first
stumble	stumble, stumbling, sin, stagger
translate	translation, translate, translator, translating, translations, transformation, term, times, time, translates
battle	battle, brawl, battles, battlefield
feel	feeling, feel, feelings, felt
also	act, action, appropriation, argument, array, above
concede	concession, compromise, convergence, ceasefire, consensus, crime, corruption, concede, coercion, constitution
split	split, separation, splitting, secession, splits
cure	cure, curing, cured, cures, condition, cycle
surface	session, surface, state, snapshot, synthesis, space, substrate
catch	catch, catching, catches, capture, caught, collection, cat, case, ception
coach	coaching, coach, coaches, championship
climb	climbing, climb, climbs, cling, challenge, construction, climbers
back	back, body, boycott
date	date, decade, dates, day, dating, days
register	register, registration, registry, record
want	want, wish, will, wanting, wants
poop	poop, problem, phase, pee, process, prank, pace, period
pause	pause, pauses
enlist	enlist, event, enlisted, engagement, election, exercise
switch	switch, shift, split, switching, swap, switches
plead	plea, pleading, petition, plead
either	entity, entities, element, expression, example
cover	cover, covering, coverage, covers, covered, conceal, cloak, crime, camouflage
spring	spring, season, state, summer, seasons
hate	hate, hatred, holocaust, hat, hating, h, hostility, hates
toast	toast, time, termination
race	race, racism, riot, racist, races, racing, rivalry, result
repent	repentance, repent, rebirth, resurrection, rebellion, reconciliation, redemption
experiment	experiment, event, experimental, experimentation, effect, example, experiments
form	form, federation, function, first, forms
kid	kid
balk	balk, block, backlash, blocking
develop	development, day, decade, days, deed
merge	merge, merger, merging, merged
still	state, silence, still, silent, second, self
Fall	fall, failure, f, fire, failing, first
score	score, scoring, success, sum, scorer, scores, song
inspire	inspiration, inspire, influence, inspired, inspiring, idea, impact, invocation, initiate, inspires
question	question, questioning, questions, quest
feed	feeding, feed, fork, feeds, food, flow, function, famine, following
clean	clean, cleaning, cleansing, cleaner, cleanup, change, condition
excel	example, exception, exceptional, excel, edge, excellence, effort
snow	snow, storm, snowball, season
jail	jail
account	account, act, accounting, argument, accusation, action, appropriation, aggregate, average, attribute
rejoice	riot, rejoice, religion
apologise	apology, act, attribution, apologise, action, apologies, above
rebound	rebound, recovery, rally, reversal, resurgence, relapse, retreat, return, response, reconciliation
rap	rap, rapper, rave, riot, remix, rappers
recognize	recognition, recognize, recognizing, recognized, result, respect
err	err, error, exception, example, errors
roar	roar, riot, roaring, rally, rage, rant
correct	correction, correct, conversion, comma, correctness, crime, case, corrective
shift	shift, split, switch, shifting
commit	commit, commits, commitment, contract, conversion, code, committing
blame	blame, boycott, blaming, behavior, body
here	how
become	body, birth, being
shut	shutdown, shut, shutting, suicide
recall	recall, recollection, remembrance, remembering, recalls, recalling, recalled, reminder, revision, record
trip	trip, travel, time, traveling, trips, tri, timeout, transportation, transport
ascend	ascent, act, archy, apex, ascend, action, awakening, attack
rank	ranking, rank, rebellion, ranks
I	i, instance, invocation, ii, index, ism, ing
wear	wear, wearing, wearable, watch, wearer
roll	roll, rolls, rolling, rolled, ritual
love	love, life, latter
nod	nod, nodding
flourish	festival, flourishing, flourish, feast, flowering, first, function
figure	figure, function, factor, first, following, form
transform	transformation, transform, transition, transformations, transforming, term, time, transformed, transforms
died	death, day, date, days, deed
steal	steal, stealing, scam, steals
launch	launch, launches, launching, launcher, latter
refrain	refrain, restraint, resistance, rest, retreat
flood	flood, flooding, flow, failure, floods
death	death, die, dying, day, deaths
interfere	interference, intrusion, interruption, incident, infringement, interfering
bed	bed, body, bedroom, block, bath
attest	act, assertion, appropriation, agreement, assault, action, abortion, argument, arrest, absolute
shrug	shrug, shift, slump, suicide
expand	expansion, extension, exponential, exception, enactment, expanding
breathe	breathing, breath, bubble, breathe, body
float	float, floating, floats, flow, function, flight, fall
cut	cut, cutting, cutter, cuts, chop, carving
wink	wink, wit, w, woo
conform	consensus, conformity, convergence, conform, consistency, cartel, compliance, conversion, covenant, circumcision
first	first, following
star	star, stars, spectrum, sacrifice, song, sorcery
disperse	dissolution, day, deed
ruin	ruin, riot, ruption
produce	production, produce, product, producer, process, producing, processing
demonstrate	demonstration, demonstrate, demonstrating, demonstrations, deed
cancel	cancellation, cancel, crime, closure, corruption, coercion
swing	swing, swinging, shift, strike, split, switch, skew, slap, stroke, slash
him	hat, human, h
terminate	termination, transition, time, terminate, term, timeout, termin
result	result
dissolve	dissolution, divorce, dissolve, deed, definition, declaration
smell	smell, scent, stink, smells, sniff, smelling, senses, sense
note	note, notes, noting
identify	identifier, identity, instance, identification, identify, imitation, initiation, id, identifying, ing
bet	bet, betting, bets, bid
preach	preaching, preach, phrase, practice
ring	ring, rings, ritual, rite
edit	edit, editing, execution, exception, error, edited, edits, expression
wish	wish, wishes, wishing, will, wished, want
despair	depression, despair, distress, depressive
differ	difference, divergence, distinction, differentiation, differences, deed
like	like, liking, lik, likes, link, list, love
hunt	hunting, hunt, hunts, harvest, hunter, hunted
collect	collection, collect, collecting, collections, collector, collected, consumption
set	set, setting, state, sum, sets, subset
spawn	spawn, spawning, session, seed, startup, state, sow
cough	cough, coughing, condition, cold, choking, c
finally	function, first
awake	awakening, awake, act, alert, awareness, aking
deploy	deploy, deployment, day, deployments, days, deploying
push	push, pushing, pull, pushes, pushed, process, pressing
instead	invocation, instance, integer, ism, instances
glow	glow, glowing
plan	plan, planning, proposal, plot, project, policy, program, plans, preparation, process
dead	death, dead, deed, die, day, dying
joke	joke, jokes, joking
mean	mean, meaning, means, measure, murder
bond	bond, bonding, bonds, borrowing, binding, banking, bundle
forgive	forgiveness, forgiving, forgive, forgiven, former
us	union
camp	camp, camping, camps, condition
well	well, work, will, wish, witchcraft
Tweet	tweet, tweeting, tweets, twitter, time, term, trend
claim	claim, claims, claiming, claimant, case
haunt	haunt, haunting, haunted, hallow, h, hacking, hat, harm
use	usage, use, user, utility, uses
only	offense, offence, object
resonate	resonance, riot, rebellion, rape, religion, resistance, ritual
direct	direct, deed
shop	shop, shopping, store, sale, shops
actually	act, action, appropriation, argument, acting, aggregate, assertion, actor, above, actions
grin	grin, grinning, gesture, gag
leap	leap, loop, leaping
focus	focus, focusing, first
state	state, states, statement, sum
mine	mine, mining, miner
loose	leak, loose, loss, latter, law
command	command, commands, coup, control, call, cat
prison	prison, punishment, predicate, pace
really	riot, rape, rebellion, religion
age	age, aging, abortion, act, adult, aged, anomaly, accident, ageing, alogue
in	instance, in, initiation, integral, itution, id, ing
reveal	reveal, revelation, revealing, revelations, result
cheer	cheer, cheering, celebration, cheers, celebrating
escalate	escalation, event, exception, execution, emergency
enroll	enrollment, event, enroll, election, entity, execution, exception
wreck	wreck, wreckage
provide	provision, provider, provide, predicate, protest, place, prohibition, provides, provided, poverty
witness	witness, witnessing, witnesses, witnessed
print	print, printing, publication, publishing, pace, place, page
prosecute	prosecution, prosecute, prosecutions, process, prosecuting, practice, piracy
touch	touch, touching, touches, time, transaction
overdose	overdose, od, opioid, omaly, outbreak, opioids, overdoses
blush	blush, bloom, blur, body
will	will, wills, wish, work
send	send, sender, sending, sent, sum
revert	revert, reversal, reset, reverted, return, reverse, rebellion, ritual
withdraw	withdrawal, withdraw, withdrawing
carry	carry, carrying, carries, carried
default	default, decision, defaults
train	train, training, time, transportation, term, transport, trains, transition, timeout, transit
bend	bending, bend, body, break, block, bent, boundary, binding, bind
practice	practice, profession, practicing, policy, protest, predicate, phenomenon, process
slay	slaying, slaughter, slay, sorcery, sword, slain
whistle	whistle, whisper, whine, whist, wit
tie	tie, tying, term, ties, ty, tied
failed	failure, fail, failing, failures, failed, fault, fraud, former, first
sew	sewing, sew, seam, stitch, sex, sis, stitching, sow
ski	split, sum, slope, snowball, sorcery
subscribe	subscription, subscribe, scribe, share, subscriptions, sum, sale, subscribers
awaken	awakening, act, action, activation, akening, adoption, abortion, attack
it	intention, invocation, instance, identity, ism, id, intent
dare	dare, daring, dared, defiance, defense
already	act, action, appropriation, argument, attack, assault, array, archy, above
slow	slowdown, slow, slowing, speed, second
debut	debut, day, days, development
tear	tear, tearing, tears, tornado, transition, time
shortly	sum, state
interrupt	interrupt, interruption, interrupts, interrupted, intercept, intrusion, ing, interference
clash	clash, conflict, crisis, collision, confrontation, crime, clashes, challenge
deal	deal, dealing, deals, deed
nurse	nursing, nurse, nurses
fragment	fragment, fragmentation, fragments, first, function
better	better, body, best
build	build, building, block, builder, builds
child	child, crime, children, childhood, class, case
one	offense, opinion, object, other, order
soften	slowdown, shift, suicide, soften, state
fast	fast, fasting, fastest, function, first
attempt	attempt, act, attack, attempted, assault, action, attempts, attempting
punch	punch, punching, punches
power	power, powers, politics, presidency, party, pace, predicate
overcome	overcoming, obstacle, outcome, overcome, omaly, olution
sweep	sweep, sweeping, sweeps, swept, swipe, state, sum
book	book, bundle, books, binding, body
respawn	respawn, resurrection, reboot, replay
curse	curse, curses, cursing, cursed, crime, condition, corruption
charge	charge, charging, crime, conspiracy, conduct, charges, commission, complaint, case, cost
rip	rip, ripping, rape
relate	relationship, relation, riot, rape, rebellion
disarm	disarm, dissolution, day, declaration, damage, definition, destruction
whisper	whisper, whispering, whispered, word, whispers, writing, words
let	let, list, letting, lets
transfer	transfer, transition, transaction, transfers, trade, transferring, transformation, time, transactions, term
increase	increase, increment, inflation, improvement, index, increasing, inequality, income
gain	gain, gift, gains, growth
chuckle	chuckle, comedy, crime
swell	swell, swelling, snowball, surfing, surf, surge, shower, storm
multiply	multiplication, multiply, multiplier, matrix, math, multiplying, mathematics
pump	pump, pumping, pulse, pipeline, pumps, process, purchase, production
murder	murder, massacre, murderer, murders, manslaughter
morph	morph, mutation, merge, murder, magic, meme
part	part, partition, piece, portion, parts, process
update	update, upgrade, updating, updated, updates
left	latter, left
double	double, doubling, dual, doubles, definition
combust	combustion, combust, conversion, crime
fracture	fracture, fragmentation, fracturing, fragment, fall, formation
retreat	retreat, resignation, rebellion, resistance
realize	realization, recognition, reality
dry	drying, drought, dry, day, drain, days, deed
wave	wave, waves, warp
spoil	spoil, stealing, state, steal, surplus, subclass, spoiled
sweat	sweat, sweating, shower, storm, sis
relax	relaxation, relax, relaxing, relaxed, release, rest, relief
text	text, translation, time, times, term, type
bear	bear, bearing, body, bundle, birth, bears
reconcile	reconciliation, reconcile, resolution, result, religion
swarm	swarm, storm, strike, species
collaborate	collaboration, collaborative, cooperative, coordination, cooperation, consensus, collaborating, contribution, concept
reverse	reverse, reversal, result, reconciliation, revolution, reversing
cost	cost, costs, consumption, corruption, costing
block	block, blocks, blocking, bind, blocker, body, blocked, blockade, break
black	black, blank, body, block
thank	thank, time, thanks, thanking, term
declare	declaration, declare, declared, declaring, definition, declarations, deed
own	ownership, owner, offense, orem
experience	experience, event, encounter, effect, exception, experiences
adopt	adoption, act, adopt, appropriation, adaptation, acquisition, action, adopting
advance	advance, advancement, action, act, attack, adaptation, advantage, acceleration, argument, advances
complete	completion, complete, closure, collection, conversion
descend	descent, divergence, derivative, deed
function	function, functions
step	step, steps, stage, stepping, second
announce	announcement, act, announce, announcing, action, accusation, announced, agreement, announcements
reload	reload, reboot, restart, replay
add	add, addition, adding, added, act
skate	skate, skating, slope, split, surfing, sport
spike	spike, surge, spikes, shock
resolve	resolution, resolve, resolved, resolving, result, resolves
up	up, union
assist	assist, aid, assistance, assisting, act, assists, agreement, assisted, attempt
boy	boy, body, block, boys, behaviour
dies	death, die, deletion, dying, deed, dies, day, deaths, divorce
chill	chill, chilling, cold, cooling
search	search, searching, searches, session, sum
offer	offer, offering, option, offered, offers
measure	measure, measurement, measures, measuring, metric, mean
spit	spit, spitting, spat, saliva, smear, spill, swearing, smoking, slap
profit	profit, profitability, positive, profits
bow	bow, bowl, bows, breach, body
eject	exit, exodus, exception, eject, event, exile, execution, expulsion, end, escape
shed	shed, shedding, split, sheds, separation, suicide
bust	bust, burst, bubble, boom, break, block, burglary, body
jam	jam, jams
corrupt	corruption, corrupt, crime, criminal, cheating, condition
wipe	wipe, wiping, wipes, wiped, wash
cringe	cringe, crisis, chuckle, cow, culture
sigh	sigh, suicide, slowdown, sleep, sacrifice, sin, sum
veto	veto, vote, void, voting
scar	scar, split
plummet	place, piracy
cycle	cycle, cycles, clock, change, coupling
scatter	scatter, scattering, swarm, split, snowball, spread, sprinkle, sorting, storm, sow
wrestle	wrestling, war, wrestle, wrestler, work
indict	indictment, impeachment, indict, insurrection, investigation, indicted
hurry	hurry, haste, h
disapprove	disapproval, dissent, disagreement, denial, disapprove, dissatisfaction, deed
game	game, games, gaming, gameplay, goal
fart	fart, ff, feces, foul
hire	hire, hiring, hour, hires
compensate	compensation, crime, correction, compensate, coercion, corruption
assume	act, assumption, appropriation, assumed, action, assume, attack, approximation, abuse, assertion
signal	signal, sign, signature, signaling, speech, signals
sacrifice	sacrifice, service, suicide, sacrifices, surplus, sacrificing, sacrificed
suspect	suspect, suspicion, suspicious, suspected
prepare	preparation, prepare, processing, protest, pace, prep, process, period, preparing, poverty
stir	stir, state, swarm, stirring, suicide, sum
relocate	relocation, relocate, removal
roast	roast, ritual, rape, runtime, result
lapse	lapse, latter, loss, law
free	free, freedom, freeing, freed, function
somehow	suicide, sum, state
topple	transition, term, terrorism, treason
tour	touring, tour, tours, travel, trip, time, traveling, times
offend	offense, offensive, offence, outrage, outburst, offend, offending, offenses
sail	sail, sailing, sails, surplus, storm, ship, shipping
hatch	hatch, hour, h, hing, harvesting, hacking, hip, how
rant	rant, riot, rage, racism
fish	fishing, fish, fry, fisherman, fishes, flood
proceed	process, predicate, progress, phase, procedure, processing, pace, period
dig	dig, digging, dump, dug, digs, deed, ding, drill
crater	crater, collision, crash, catastrophe, crisis, crime
wash	wash, washing, work
light	light, led, lighting, lamp, laser
shit	shit, stuff, spat, situation
throw	throw, throwing, thrown, toss, throws, time, tossing, threw
boom	boom, bubble, bust, burst, body, banking, borrowing, bank
upload	upload, uploading, usage, user
reform	reform, revolution, restructuring, reforms, referendum, reforming
divine	divine, deity
mend	mend, murder
satisfy	satisfy, satisfied, set, satisfies
predict	prediction, predictor, predict, predicted, predictions, probability, plan, prophecy, predicate, process
myself	
convict	crime, convict, conviction, confession, conspiracy, case, criminal, convicted, crimes, corruption
litter	litter, latter, law, loss
progress	progress, project, process, phase, pace
RIP	riot, rape, result
more	more, multiplier
discover	discovery, discover, discovering, day, deed, definition
boot	boot, boycott, body, boots
design	design, designer, decision, definition
divide	divide, division, divergence, differentiation, difference, definition, dividing, divides
herself	hip
police	policing, police, protest, predicate, party
vent	vent, void, verb, violence
okay	okay, omaly, ok, offense
rupture	rupture, rift, ruption, riot, rebellion, resistance
rage	rage, riot, rant, rebellion, revolt, rampage
capture	capture, crime, captures, capturing, confession, coup, collection, coercion, catch, cat
shudder	shudder, shaking, shake, scream, sham
reach	reach, revolution, result, reaching
fix	fix, fixing, fixed, fixes, fault
bless	blessing, bless, blessed, blessings, body
box	box, boxes, boolean, block, body, boxed, bundle, blockade
handle	handle, handling, hing, hat, handler, h, heap, how, hand
conquer	conquest, conquer, conflict, conquering, conquered, crime
after	act, action, abuse, argument, acting, array, after, above, actions
court	case, constitution, cases, court, conflict, coalition
control	control, coercion, coup, cartel, controlling, crime, condition
shove	shove, snowball, squeeze, slap, stuff
likely	likely, likelihood, latter, law, lihood, legislation
rape	rape, rapist, raping, riot, rapes
stall	stall, shutdown, slowdown, stalls
list	list, listing, lists, latter
if	if, instance, ing
hail	hail, hurricane, hour, how, harvest
scale	scale, scaling, size
paint	painting, paint, process, painter, paintings, phase, pain, processing, period, place
lay	lay, law, laying, lie, land, latter, legislation
balloon	balloon, bubble, balloons, bundle, body, boom
unravel	
mate	mate, mating, match, marriage, mates
fill	fill, filling, function, fills, following, filler, first
rent	rent, rental, renting, rents
vary	variation, variance, variable, violence, variability, version
enjoy	enjoyment, enjoy, excess, effect, eclipse, event, ecosystem, expression, enjoying, entertainment
fine	fine, fault, failure, function, failing, foul, first, felony, following
doubt	doubt, denial, delusion, dispute, disagreement, deficit
cop	cop, crime, crimes, cartel, contract, comma, collection, condition
referee	referee, review, referees, rule, role
betray	betrayal, betray, betrayed, breach
host	hosting, host, hospitality, hosts, hosted, how, hip
scan	scan, scanning, scanner, scans, screen, snapshot, search, session, second, scanned
embrace	embrace, embracing, event, engagement, embraces, existence
home	home, house, household, hour, housing
protect	protection, protect, protected, protects, protecting, predicate, privilege, pledge
overlap	overlap, overlapping, omaly
dawn	dawn, day, days, development
good	good, gift, goodness
Win	win, w, wins, winning
decay	decay, death, disease, degradation, day, damage, die
that	term, tree, things
reboot	reboot, restart, reset, revival, restoration, rebirth, rebuild, resurrection, recovery, reverse
boast	boast, boasting, bragging, bole
crawl	crawl, crawling, craw, crash, corruption, crime, core, ching, copying
man	man, murder, moment
receive	receive, receiving, receipt, request, recipient, response, receiver, reception, received, return
conclude	crime, conclusion, closure, completion, case, close, convergence, corruption, coercion, conversion
resume	resume, restart, reboot, reset, restore, return, resumes, response, review
put	put, place, puts, predicate, putting, pace
blind	blind, blindness, blinded, blinding, blank, black, body
resurrect	resurrection, reboot, restart, revival, resurrect, rebirth, respawn, return, ritual, religion
flow	flow, flows, function, flowing
farm	farm, farming, farmer, farms, fork, factory
defend	defense, defend, defence, defending, defended, deed
all	act, action, agreement, association, array, assembly, all, aggregate, actions, acts
trump	trump, term, trust, time
her	hip, how
he	he, hat, h, husband
reproduce	reproduction, reproduce, replication, rape, relationship
riot	riot, rebellion, revolt, robbery, riots, rage
press	press, protest, pressing, publication, presses, propaganda, push, publicity, place
skyrocket	spike, suicide, success
breed	breeding, breed, breeds, birth
echo	echo, event, exception, example, error, expression, execution, effect
so	state, sin, sum, same
photograph	photograph, photography, photo, photographs, portrait, picture, process
face	face, facial, faces, first
recoil	recoil, reaction, rally, riot, result, response, rebound, reflex, rage
bowl	bowl, body, bowls, bow, blessing, bowling
arrest	arrest, act, abduction, assault, arresting, arrested, arrests, attack, apprehension, action
stare	stare, staring, silence, stares, sight, stared
unite	union, unification, unity
trust	trust, transaction, trusting, trusted, trusts, term
drift	drift, divergence, drifting, deviation
tread	tread, time, term, threshold, tire, trespass
gasp	gasp, gag
spell	spell, spells, spelling, sorcery
beam	beam, beams, body
beware	block, body
mobilize	mobilization, mass, movement, moment, mobilize
no	no, null
bring	body, bring
curl	curl, condition, closure, curve, contraction, curls, catch
fuse	fuse, fusion, fire, function, flame, first, fit, following
wins	win, wins, winner, winning, work
scoff	scoff, stealing, swearing
cum	cum, cluster, combine, convergence, climax, collision, condom, coupling
clear	clear, clearing, clears, clarity, condition, case, crime, conversion, confession, covenant
trigger	trigger, triggering, threat, triggers, time, triggered, timeout, tap
hike	hike, hiking, hikes, hikers, h
hell	holocaust, hell, how
chip	chip, computation, computing, collision, chips, chunk, clock, conversion, click, compute
verify	verification, verify, validation, verified, verifying, validate
shake	shake, shaking, shift, shakes, shook
once	offense, object, once, oning
reason	reason, rationality, reasoning, rational
twitch	twitch, tick, time, tap, typing, ting
applaud	applause, applaud, act, agreement, action, appropriation, assembly, assault, applauded, activism
operate	organization, operation, offense, oning
solo	solo, standalone, song, singing, space, single, split, sum, state
self	self, sacrifice, suicide, state, sphere
integrate	integration, integrate, invocation, injunction, ism
perhaps	protest, predicate
teleport	teleport, teleportation, transition, time, term, transfer, transformation, transit, travel, transport
convince	convincing, convince, consensus, crime, coalition, convinced, con, confession, cooperation, conversion
record	record, recording, records, retrospective, register
sound	sound, speech, song, speaker, sounds, signal
upgrade	upgrade, update, upgrading, upgrades
this	tree, term, time, tuple, thing
life	life, living, law, lifetime
baby	birth, baby, body, breastfeeding, block, bundle
shower	shower, showers, session, shaving
wind	wind, wave, weather, winds
pack	pack, packing, package, packs, payload, process
however	homicide, holocaust
tip	tip, tipping, tail, tipped, term, theft, technique, trick
project	project, projects, phase, process, programming, proposal, program, projection, period
anyways	act, assault, action, appropriation, argument, abortion, array, atom, above
repay	repayment, refund, recovery, return, repay, remainder, restitution
sob	suicide, state, sob, split, sum
reject	rejection, reject, refusal, rejects, rejected, rejecting, rebellion, revolt, refuse, result
duck	duck, ducks, delay, delta, dance, dunk, drawing
broadcast	broadcast, broadcasting, block, broadcasts, body
delay	delay, delaying, denial, delays, diversion, delta
inform	inform, instance, imitation, informal, ing
slice	slice, slicing, slices, split, slash, sum
communicate	communication, conversation, channel, communicating, communications, communicate, concept, call
copy	copying, copy, clone, copyright, conversion, cat, cloning, collection, change
hand	hand, handshake, how, hands, handing
mature	maturity, mature, milestone
contend	conflict, contest, clash, crisis, contention, crime, controversy, competition, case, corruption
wed	wedding, wed, wife
stray	split, stray, separation, suicide
dress	dress, dressing, dance, definition
observe	observation, observe, observer, observed, observable, observing, omaly, observ, observations
peak	peak, period, plateau, phase, pace, process
deny	denial, deny, dispute, disagreement, denying, definition, denied
compare	comparison, compare, correlation, comparing, comparisons, critique, comparative, contrast, compliment, credit
storm	storm, storms, shutdown
restore	restore, restoration, reboot, restored, reset, restoring, restart, recovery, return, restores
restart	restart, reboot, reset, rebuild, restoration, reverse, recovery
charm	charm, charms, conjunction, compliment, collision, couple, case, conditional
stone	stone, strike, sword, sum, state
code	code, compiler, coding, computation, callback, class, collection
deflect	deflect, disagreement, disconnect, distraction, duel, distinction, deed
won	win, wins, winner, winning, work
tumble	tumble, term, theft
feature	feature, function, features, functionality
appreciate	act, appreciation, appropriation, action, attribute, abundance, art, appreciate, apology, appreciated
time	time, times, timer, timestamp, timeout
fare	fare, f, fair, failure, feast, failing, famine, festival, food, fficiency
else	entity, entities, exception, evil, example, exclusion, expression
dictate	dictate, directive, definition, decision, declaration
cause	cause, crime, conspiracy, cure, causation, collision, causes, cascade, consequence, condition
depend	dependency, dependence, dependent, dependencies, derivative, depend, deed
what	what, work, will
fumble	fumble, failure, fault, ft, function, football, following, first
hover	hover, hovering, h, hip, how, hold, hand
hug	hug, hugging, handshake, hugs, h, hi
harvest	harvest, harvesting, hour
piss	piss, pee, poop, process, penis, period, pd, predicate
abort	abortion, abort, aborted, attempt, act, adoption, abortions, attack, abandonment
space	space, spectrum, sphere, separation, sum
orbit	orbit, orbital, orbiting, omaly, orbits, observation
brew	brew, brewing, boil, batch, beer, brewery, brewer
supply	supply, substitution, surplus, stream, supplier
rescue	rescue, rescuing, response, recovery, relief, rebound, result
compute	computation, compute, computing, calculation, code, call
on	offense, ordinance, offence, occupation, oning, on, object, operation
allow	act, action, appropriation, attack, arrest, allowed, allow, argument, assert, above
frown	frown, face, first, former
rewrite	rewrite, rewriting, revision, rename, redesign, reform, rite, restructuring
engage	engagement, engage, event, engaging, exchange
divorce	divorce, dissolution, day
defeat	defeat, death, defeats, deficit, defeated
fear	fear, first
often	offense, overlap, occurrence, oning
impress	imitation, insult, impress, instance, impact, ing, ism
yes	yes, yea
OK	ok, okay, omaly, offense, o, order
name	name, namespace, naming, noun, nickname, names
delete	deletion, delete, deleting, deleted, dump, death, day, destruction
strip	strip, stripping, stripped, slice, sex, strike, segment, sum, strips, state
both	body, bundle
boil	boil, boiling, boils, bubble, body, boiled, boiler, brewing, burning
lift	lift, lifting, lifts, leap, latter, liquidity
moan	moan, moaning, malfunction, moment
summarize	summary, sum, summarize, statement, state, summarized, stack
weld	weld, welding, work
challenge	challenge, conflict, challenges, contest, crisis, criticism, challenging, competition, challenged
review	review, report, recommendation, resolution, reviews, reviewing, reviewer, research
pretend	pretend, pretending, prank, play, pathy, practice, predicate, pretended
down	down, deed, descent
achieve	achievement, act, achieve, accomplishment, achieved, action, activity, agreement, aim, above
request	request, requests, response, requesting
long	long, length, lifetime, list, life
thing	thing, things, term, time, type
succeeded	success, suicide, successful, state
rush	rush, rushing, rushes, robbery
flock	flock, farming, flow, first, following, fast
homer	homer, homicide, holocaust, h
by	body, by, binding
weigh	weight, weighing, work, will
defect	defect, defects, default, damage
party	party, protest, politics, parties, predicate, process
distract	distraction, distract, disconnect, diversion, delay, distracting, disruption, distracted, distractions
cool	cool, chill, cooling, condition, creativity, cascade, concept, crash
recruit	recruiting, recruit, recruitment, recruits
sniff	sniff, smell, search, scent, sorting, scratch, smells
align	alignment, act, association, alliance, agreement, action, appropriation, argument, above
immediately	instance, injunction, invocation, instances
fret	fret, ference, function, following
empty	empty, emptiness, exception, entity, expression, example, existence
transition	transition, transformation, time, transitions, termination, term, transfer, transitioning
infect	infection, infect, infected, infections, instance, incident, ing, intent
day	day, days, date
itch	itch, itching, infection, issue, illness, injury, irritation, ing
forfeit	forfeit, forfeiture, following, failure, foregoing, felony, former, fall
sense	sense, self, state
evacuate	evacuation, exodus, emergency, event, exception, exit, eruption, eviction, expulsion, evacuate
top	top, tuple, theft, time
them	term, times, tree, time, threat, things
demand	demand, demands, default, day
pretty	pretty, predicate, pace, pair, poem, poetry, party, property, play
cap	cap, coup, ceiling, caps, crime, contract, case, coercion
abide	act, agreement, assault, abortion, appropriation, action, arrest, attack, arrangement, accord
girl	girl, girls, gender
nest	nest, nesting, nests
commute	commute, commuting, collision, commuter
key	key, keys, king
BE	body, bundle
patrol	patrol, patrolling, policing, patrols, procedure, protection, period
create	creation, creator, create, collection, constructor, creating, construct, cause, created
hopefully	homicide, holocaust
shock	shock, seizure, spike, stroke, suicide, shaking, shocks
seem	state, suicide, sin, sum
present	present, predicate, pace, past
capitalize	capitalize, crime, cap, conversion, comma, claim, corruption, case, coercion
file	file, filename, following, function, first, files
guard	guard, guarding, guards
am	act, action, appropriation, assault, abortion, adultery, argument, aggregate, array
solve	solve, solution, solving, success, sum, solutions, solved, solves
just	just, justice
we	we, work
head	head, heading, hierarchy, h, hat, heads, homicide
breakdown	breakdown, breakup, break, body, bb
drip	drip, drop, drinking
off	off, offense, offence, offset, overload, on, oning
discriminate	discrimination, discriminate, discriminatory, discriminating, difference, disparity, distinction
accelerate	acceleration, act, attack, action, appropriation, accelerate, assault, abortion, assassination, accelerating
chew	chewing, chew, cutting, crunch
invest	investment, invest, ipo, index, issue, investing, ico, investor, investments, income
bullshit	bullshit, body
spend	spend, spending, sum, surplus, spends, shopping
spin	spin, spinning, spins
flash	flash, flood, flashing, flashes, flare, fast
God	god, gift
mount	mount, mounting, moment
snowball	snowball, storm, snow, sorcery
jog	jog, jump
compromise	compromise, concession, conflict, ceasefire, crisis, consensus, compromises, cooperation, coordination, corruption
alone	act, adultery, action, alone, assault, abortion, affair, aggregate, argument, array
Fail	failure, fail, failing, failed, failures, following, fraud, fault
retract	riot, rebellion, rape, resistance
collide	collision, convergence, crash, clash, conflict, collide, collisions, crime, conversion
foul	foul, felony, fraud, following, fou, ft, first, fair
freelance	freelance, former, form, following, first
wolf	wolf, wolves
guarantee	guarantee, guarantees, guaranteed, guaranteeing
repeal	repeal, reconciliation, referendum, replacement, reform, regulation
misunderstand	misunderstanding, mistake, mismatch, misunderstand, murder
taste	taste, tasting, term, time
address	address, act, action, argument, agreement, apology, appropriation, addressing, addresses
sway	sway, split, shift, strike, swing
repair	repair, restoration, repairs, reconstruction, renovation, recovery, remedy, rehabilitation, repairing, rebuild
wrong	wrong
campaign	campaign, campaigning, campaigns, coup, candidacy, candidate, cycle
to	to, term, time, times, tree, t, transaction
anchor	anchor, association, act, alliance, aggregation, alignment, anchored, action, affinity, attack
venture	venture, ventures, vc
definitely	definition, deed
renew	renewal, renew, ritual
download	download, downloading, downloads, distribution, donation, dump, day
even	even, equality, equal, event, entity, exception, example
derail	disruption, disaster, day
vacuum	vacuum, void, vacancy, vortex, violation, vapor
answers	answer, act, action, argument, affirmative, analysis, answered, agreement, answers
contract	contract, contracting, contracts
phone	phone, peak
rethink	rethink, revolution, revision, reform, reflection, review
unfold	unfolding
bike	bicycle, bike, biking, bicycles, body, block
chat	chat, conversation, chatting, callback, chats, call, chan, communication
steer	steer, shift, split, steering, sacrifice, strike, slaughter
coin	coin, coins, conversion, currency, cycle, contract, change, cash
recharge	recharge, reboot, rebirth, refill, renewal, reset, retreat, ritual, revival, rest
two	term, tuple, two, time, times
abound	act, aggregate, assault, abortion, appropriation, action, attack, arrest, assassination, abundance
manifest	manifest, manifestation, moment, manifests, magic
worsen	worsening, worst
piece	piece, pair, place, puzzle, pieces, part, pace, play
school	schooling, school, schools, sum, state, surplus
reopen	restart, recovery, restoration, reboot, restore, riot, reopen, rebellion
enough	end, example, entity, event, exception, exponential, entities
Posted	pace, protest, predicate, property, place
DJ	dj, dance, djs, dancing, demo, day
migrate	migration, migrate, migrating, move, migrant, movement
way	way, will
torture	torture, tort, term, terrorism, tyranny
invite	invite, invitation, inviting, invited, invites, initiate, initiation, invocation, instance, ing
crest	crest, cascade, crime, collision, conversion, comma, circumcision, coercion, corruption
define	definition, data, declaration, definitions, deed, define, defining
WIN	win, winner, wins, w, wit, winning
disband	dissolution, day, disband, days, disobedience
surely	suicide, state, sum
survived	survival, suicide, success, surviving, survived, survive
license	license, licensing, licenses, llc, law, licence, legislation, latter, licensee
there	term, tuple, tree, time, thing
year	year, years
pale	pale, paradox, pace, period, place
OD	od, offense, overdose, object
advise	advise, advice, advisory, advising, advisor, act, assist, adviser, agreement, association
Survive	state, suicide, sum
consider	consideration, consider, considering, collection, count
type	type, typing, tuple, term, transformation, time, types, times
separate	separation, split, separate, separating, secession, second, same, sis
skip	skip, skipping, split, steal, skipped, stealing
drag	drag, dragging, dance, dress
spot	spot, spotting, sight, sighting, success
sunset	sunset, sunrise, shutdown, sun
most	
reside	riot, rape, robbery
expect	expectation, expect, expected, estimate, event, expects, example, error, expectations
college	college, class, course, century
order	order, ordering, ordered, ordinance, organization, orderly, orders
lock	lock, locking, locks, locked, lockdown, loop, latter
rear	robbery, rape, riot, result, rear, resistance
quote	quote, quotation, quoting, quotes
interview	interview, interrogation, interviewer, investigation, interaction, interviewing, interviews
away	act, absence, appropriation, away, assault, abduction, action, attack
son	son, sum, sacrifice, state, sin
bald	body, block, bug, beard
might	might, may, moment
stitch	stitch, stitching, sewing, stitches, seam, sow
stump	stump, state, split, sum, speech, slaughter
course	course, correction, consequence, cascade, case, comma, conditional, condition, conduct
over	over, offense, overlap, overflow, overthrow, occupation, overhead, on, oning
Cry	crime, collection, condition, corruption
she	she, state, sum, self, sacrifice
grace	grace, gift, gesture
swoop	swoop, swarm, swap, sweep, swipe, sky
support	support, supporting, supports, state, supported, supporter
lecture	lecture, lectures, learning, latter
debate	debate, disagreement, dispute, discussion, dialogue, democracy, discourse, debating, debates
reap	reap, riot, rape, robbery, result, ribution, religion
themselves	term, tree, time
stew	stew, state, swamp, soup, surplus, storm
trade	trade, trading, term, transaction, treaty, tariff, tax, time
known	known, knowledge, knowing, know
dot	dot, dots, definition, dash
malfunction	malfunction, mistake
lack	lack, latter, lessness, loss
avail	act, action, appropriation, arrest, assault, aggregate, api, agreement, assertion, avail
yawn	yawn
consent	consent, consensus, contract, compromise, covenant, cooperative, consensual, coercion, conduct, control
brawl	brawl, battle, bout, boxing, body
reflect	reflection, reflect, result, return, riot, rebellion, reflecting, real, religion
pursue	pursuit, period, pursue, pursuing, process, project, phrase, partnership, progress, practice
proof	proof, predicate, process, proofs
speed	speed, speeding, sprint, stroke, speeds, slowdown, slow, second
place	place, protest, property, predicate, person, pace
sketch	sketch, sketches, split, session, state
quickly	
plot	plot, plotting, play, plan, plots, pace, projection, programming, predicate, place
trick	trick, tricks, trap, time, technique
invade	invasion, intrusion, invade, intruder, invading, infection, interference
gamble	gambling, gamble, game
determine	decision, definition, determination, deed, differentiation
coast	coast, coastline, crime, curve, cliff, collision, case, corruption, conversion, coercion
latch	latch, lock, loop, locking, ling
gel	gel, group, glue
stroke	stroke, strokes, seizure, suicide, second, split
opt	opt, option, outcome, operation
brain	brain, body, brains
eclipse	eclipse, event, eclips, election, effect
sour	sour, spill, shutdown, sis
badly	burglary, bad, body
perfect	perfect, perfection, predicate, partial
loot	loot, looting, latter, luck, looted, loss, lock
mix	mix, mixing, mixture, mixer, merge
shovel	shovel, snowball, sow, sum, stack, strike
parent	parent, parenting, parental, predicate, parents, pair, pace
elect	election, elect, electorate, event, exception, elected, example
zero	zero
rocket	rocket, rockets, revolution, rally
filibuster	filibuster
shred	shred, split, separation, shutdown, stealing, sacrifice, sword, strike
expose	expose, exposure, exposing, exploit, exposed, exposes
reconnect	reconnect, reconciliation, reunion, relationship, return, restoration, recall
nail	nail, nails
s	s, sum, sin, state, set
ignite	ignite, incident, instance, ignited, invocation, initiation, ite, ing, ism
mail	mail, mailing, month, message, mailbox
dispute	dispute, disagreement, disputes, discord
circulate	circulation, crime, crisis, community, corruption, conspiracy, collective, cluster, cycle
dust	dust, day, desert, dirt
size	size, sizing, sizes, small, sum, scale
mushroom	mushroom, mushrooms, method, magic
dwell	day, deed
Skype	skype, session
sprint	sprint, startup, snapshot, split, second
grate	grate, gesture, gift
override	override, overriding, overload, overflow, operation, option
white	white, whites
fib	fib, fraud, flow, function, ff, f, fabrication, following
mother	mother, marriage, mating, merger, mothers, mom, merge, ma
crow	crow, coup, celebration, cow, ceremony, condition
weather	weather, wind
harm	harm, homicide, hurt
reward	reward, repayment, rewards, result, rewarding
a	act, action, argument, a, attack, array, above, actions
spew	spill, spew, spitting, swearing, slur, speech, spat, spit
revive	resurrection, revival, reboot, restart, revive, rebirth, resurgence, recovery, reset, return
replace	replacement, replace, return, replacing, riot, rebellion
punt	punt, pun, penalty, possession, place, play, protest
blast	blast, burst, bomb, bombing, bubble, blasting, bang, burn, body, blasts
Live	life, law, latter, log, legislation, lifetime
scroll	scroll, scrolling, scrolls
provoke	provocation, provoke, provoking, protest
represent	representation, rebellion
slam	slam, slamming, slams, slammed, smash, strike, sum
alert	alert, alarm, awareness, act, action, attack, activity, alerts
email	email, exchange, event, error, example, exception
red	red, rebellion, riot, revolution, row, result
stack	stack, stacking, sum, stacks
spar	spar, strike, split
fulfill	fulfillment, function, fulfilled, fill, fulfill, felony, fulfilling, first, following
desert	desert, drought, decline, deed, death
pin	pin, pair, p, pointer, place, pi, predicate, prank, pace, process
father	father, fathers, function, first
track	track, tracking, tracker, trace, time, term, task
job	job, jobs
ensure	execution, entity, exception, event
innovate	innovation, invention, improvement, innovate, impact, inventor, innovative, idea, innovations
late	late, lapse, latter
flag	flag, flags, following, function
sober	sober, state, spirit, suicide
zip	zip, zipper, zing
fuel	fire, fuel, first
heat	heat, heating, hot, hurricane
acknowledge	act, agreement, acknowledgment, acknowledgement, acknowledge, action, appropriation, apology, argument, acceptance
troll	troll, trolling, trolls, threat, term, theft, time, torrent
heart	heart, h, heartbeat
gather	gathering, group, gather
negotiate	negotiation, negotiating, negotiations
gold	gold, gift, golden
maintain	maintain, murder, maintained, maintaining, maintenance
tattoo	tattoo, tattoos, trademark, term, ting
revise	revision, rewrite, riot, regression, rebellion, rape, review, revisions
brake	brake, braking, block, bottleneck, brakes, binding
activate	activation, act, attack, action, activity, activate, agent, actions, above
parachute	parachute, phase, process, pilot, practice, place, pace
second	sum, second, state, sin, split, sentence
lost	loss, lost, losses, latter, losing, lose
sample	sample, sampling, synthesis, samples, survey, study, session, snapshot
ultimately	union
surf	surfing, surf, session, swim, sport
sometimes	sin, suicide
exercise	exercise, exercising, event, exception, ercise, expression
easily	execution, entity, exception, example, expression
honor	honor, honour, honoring, honors, hon
Sunday	sunday, sabbath, surplus, saturday, split, sundays, service, shift
include	invocation, integral, injunction, index, instance, include, item, ism
tackle	tackle, tackling, tackles, time, team, term
cruise	cruise, cruising, carnival, collision, crash, condition, case
sir	sin, sum, state, sacrifice
single	sum, state, single, split, suicide
at	act, appropriation, action, argument, assault, attack, array, aggregate, above, aggregation
Be	body, bundle, block
ID	id, identification, identity, identifier, instance, ids
ready	ready, readiness, runtime, ritual, rite, rebellion, revolution
blank	blank, block, body, buffer, blockade, blocking
redirect	redirect, redirected, route, riot, return, rebellion
yellow	yellow
none	null
earn	earn, earning, earned, event, example, effort
illustrate	illustration, instance, invocation, injunction, ism, illustrating
recommend	recommendation, recommend, report, recommendations, ritual, religion
inevitably	instance
converge	convergence, converge, collision, cluster, crime, conversion, communism
dive	dive, diving, dip, dives, dump, drop, diver, delta, dove, day
wit	wit
soul	soul, sacrifice, suicide, spirituality, state, split, spirit, sum, second
rake	rake, result, return, roll
sag	sag, slump, suicide, split
approach	approach, action, act, attack, attitude, adaptation, argument, approaches, a
influence	influence, impact, intervention, interference, interaction, intention, influencing, influences, intent
Miss	murder, misdemeanor
park	park, parking, place, pace, protest, parks, party, play, property, practice
trace	trace, tracing, time, track, traces, transformation
ha	hat, holocaust, h, ha, homicide, how, hab
await	await, act, action, attack, appropriation, argument, assassination, arrest, awaiting, async
jar	jar, jars
gone	gone, ghost
document	document, declaration, documentation, deed, documents, definition
grab	grab, grabbing, grabs, get
partake	party, partnership, participation, possession, process
disconnect	disconnect, divorce, day, default
literally	law, latter
flirt	flirt, feud, first, former, following
surpass	surplus, success, suicide, sacrifice, sin
guide	guide, guiding, guidance, grouping, guideline
Wed	witchcraft, where
delegate	delegate, delegation, delegated, delegates, diplomacy, directive, definition
deserve	deserve, demand, deserving, deserves, deed
commence	crime, conspiracy, criminal, corruption, coercion, conduct, commencement, cessation
Google	google
entertain	entertain, event, execution, entertaining, exhibit, episode, entertainment
wanna	wish, will
cast	casting, cast, casts, comedy
accomplish	achievement, act, accomplishment, action, achieve, achieved, aggregate, accomplish, appropriation, actions
persuade	persuasion, persuade, persuasive, petition, proposal, process
chant	chant, chanting, chants, chanted
govern	government, governance, govern, governing
diminish	decline, dissolution, depletion, decrease, down, deed
unveil	unveiling, unveil
bottle	bottle, body, bundle, block, breach
interpret	interpretation, interpret, interpreter, invocation, injunction, ism
sustain	sustain, surplus, sustaining, sustained, state, support, sacrifice
draft	draft, drafting, day, drafts, declaration, document
educate	educator, education, election, event, example, emia, evil, educating
counter	counter, crime, coup, check, countering, ception, coercion
bind	bind, binding, bound, bundle, binds, body, bond
warn	warning, warn, warnings, warned, witchcraft
narrow	narrowing, narrow
explore	exploration, experiment, explore, encounter, exploring, event, explosion, expression, exploit
calculate	computation, crime, calculation, conversion, corruption, coercion
premiere	premiere, production, phase, premier, premie, proposal, performance, play, practice, pace
seize	seizure, seize, seizing, seized, seizures, steal, stealing, second
flame	fire, flame, fireball, fuse, flaming
drone	drone, drones, day, deed
bat	bat, body, block
recite	riot, rebellion, rape, ritual, religion
sooner	suicide, split, state
fruit	fruit, fruits, fig, fermentation, function, food
night	night
bluff	bluff, bubble, blocking
bob	body, block, bundle, burglary
gag	gag, glitch, gift, gesture, gging
war	war, warfare, wars, win
hint	hint, hints, hat, h, how
tick	tick, time, timestamp, ticking, transaction, tattoo, ting, threshold, tie, ticks
creep	creep, crime, ception, crimes, criminality, condition
detect	detect, detection, detecting, detector, detected
consume	consumption, consume, consuming, consumed, consumes, collection, consumer
amend	amendment, act, amend, appropriation, alteration, amended, addition, article, amendments, action
disclose	disclosure, disclosures, disclosing, declaration, disclose, deed
detail	detail, design, description, definition, data
bother	bother, body, behavior, boycott, burden
stress	stress, stressed, strain, slowdown, situation, state, stresses, sis
LIVE	life, law, lifetime, log, legislation, latter
flush	flush, flow, flood, flushed, float, function
dim	dim, death
conflict	conflict, crisis, crime, contradiction, clash, conflicts, contention, case
rat	rat, rebellion, ritual, result
lol	laughter, list, latter, law
imagine	imagine, idea, imagining, instance, imagination, imaginary, illusion, intention
organize	organization, organisation, ordinance, organizing
bid	bid, bidding, bidder, block, bids, binding
ghost	ghost, ghosts, glitch
cancer	cancer, cure, cancers, chemotherapy, condition, case, crisis, cell
ice	ice, iceberg, instance, interval
Blink	blink, block, body, bug, binding, blackout, balance
rescind	revocation, retreat, riot, rebellion, rescind
recycle	recycling, recycle, reuse, recovery
erase	erase, exception, event, error, edit, empty, exile, editing
permanently	property, predicate, phase, pace
brother	brother, bond, body, bonding, binding, brothers, bundle, block
avoid	act, avoid, avoidance, action, attack, assault, avoiding, above
bill	bill, budget, bills, borrowing, billing
dock	dock, docking, day, discharge, deed, default
remove	remove, removal, removing, removed, return
NOT	null
sort	sort, sorting, sorted, separation, same
suicide	suicide, suicides, sis
roam	roaming, roam, runtime, robbery, riot, rape, rebellion, range, rage, ritual
concentrate	concentrate, concentration, convergence, cluster, consolidation, crisis, coordination, concentrating, consumption, crush
Saturday	saturday, sabbath, surplus, sin, sunday, saturdays
bankrupt	bankruptcy, breakdown, bankrupt, borrowing
climax	climax, culmination, conclusion, coup, completion
yesterday	yesterday
knit	knit, knitting, knot
stabilize	stabilization, stabilize, stability, stable, stabilized, state, success
coincide	convergence, coincidence, collision, conjunction, correlation, crime, coordination, composite, cluster, conversion
load	load, loading, loop, loads, loader, latter
labor	labor, labour, law, latter
soldier	soldier, service, sacrifice, soldiers, sword, state, sum
conceive	conception, creation, ception, crisis, conversion, covenant
truth	truth, testimony, term, true, tree, totality
trumpet	trumpet, trump, truce, time, term
contest	contest, competition, conflict, challenge, contests, competitions, case
purge	purge, process, practice, place
Pass	predicate, prayer, property
ya	
cake	cake, cakes, celebration, cooking, collection, condition, case
revenge	revenge, rape, retaliation, riot, retribution, revolution, result
screw	screw, screws
bump	bump, bounce, body, block, buff, bumps, beating, blocking
absorb	act, absorption, absorb, appropriation, action, abortion, assault, attack, acquisition, assassination
upset	upset
truck	term, time, truck, transaction, tree, trade, times, transportation, theft
spare	spare, state, sacrifice, sum, suicide
aid	aid, act, assist, assistance, alliance, ally, action, agreement, assisting
reset	reset, reboot, refresh, restart, return
warm	warm, warming, warmth, warmer
raise	raise, raising, rise, raises, rebellion, rent
worship	worship
rather	riot, rape, rebellion
stalk	stalk, stalking, swarm, sorcery
spiral	spiral, split, sis
lives	life, lifespan, lifetime, living, law, lives, legislation
fal	felony, failure, function, fall, flow, following, first
decipher	divergence, decipher, decoding, dictionary
criticize	criticism, critique, complaint, controversy, criticizing, critic, criticize, criticisms
defer	defer, delay, deferred, default, delta, deed
disembark	departure, day, delay, deed
thin	term, thin, time, times, thickness, thinner
color	color, crime, colors, condition, coloring
salute	salute, standing, support
ad	act, ad, appropriation, adultery, ant, action, aggregate, argument, array, association
shot	shooting, shot, shoot, shooter, shootout, shootings, shots
retrieve	retrieve, retrieval, return, response, retrieving, recovery, result, reuse, receipt
don	deed, definition
fat	fat, fatty, famine, fats, fry, former
flower	flower, flowering, festival, flowers
delight	delight, dance
frost	frost, freeze, freezing, fire, fall, first
weaken	weakening, weakness
slot	slot, sum, split, slots, substitution, set
juice	juice, ju
boycott	boycott, blockade, bds, blackout, backlash, boycot, body
grave	grave, graveyard
sneak	sneak, steal, stealth, slip, sneaking, stealing, sis, stalking
twist	twist, transformation, transition, twisting, turn, twists, trick, term, time
STOP	stop, state, shutdown
waiver	waiver, waivers, workaround, waive
scrape	scraping, stack, sum, state, strike, stealing
another	act, action, attack, argument, appropriation, association, activity, aggregate, alias
best	best, bargain, behavior, better
some	sum, some, state
otherwise	omission, outlaw, ordinance, obstruction, object, opposite
intercept	intercept, interception, intercepted, incident, intrusion, instance, intelligence
quake	quake
spy	spy, spying, surveillance, spies, sis
sub	sub, sum, subclass, slice, subset, split, sin
specialize	specialization, specialty, surplus, suicide, synergy, specialize
why	why, what
surge	spike, surge, storm, second
Sue	state, sum, suicide, sin
breach	breach, breakdown, breaches, breaching, body
welcome	welcome, welcoming
impact	impact, intervention, influence, incident, impacts
three	three, trio, tuple, third, term, time, triangle, tri, trilogy, trinity
smack	smack, slap, strike, slapping, stuff, smash
re	re, result, return, repeal, reform
scoop	scoop, sweep, snowball, sum, search, sorting, sampling
done	deed, done, do, doing, deal, did, day
something	statement, something, speech, sum, state
cold	cold, chill, cooling, condition, case, conditional
consult	consultation, consult, consensus, conversation, collaboration, consulting, communication, contract, council
peel	peel, process, potato, pie, peeled, procedure, place
trial	trial, trials, time, treason, term, times
grunt	grunt, grinding, grind
dope	dope, drug, dip, drugs
RT	rt, retweet, reporting, result, runtime
slap	slap, slapping, smack, slash, strike, spat, sum, split
nothing	nothing, null
final	final, function
require	requirement, request, require, requirements, runtime
prey	predator, prey, poaching, predicate
alter	alteration, alter, act, anomaly, alias, action, altering, amendment, adjustment, alterations
chose	choice, chose, crime, choose, choosing
lag	lag, latter, latency, log, lock, loop
journey	journey, journeys
film	film, filmmaking, films, feature, filming, form, frame, first
because	body, boycott
tend	theft, term, time, trend, tendency, terrorism
force	force, felony, forcing, fighting, forces
worse	worse, worst
mark	mark, marking, marks, marker, marked, markup
ly	law, latter
parole	parole, pardon, probation, process, procedure
neither	null
chase	chase, chasing, catch, cat, competition, collision, ception
boo	boo, brawl, bug, body, boycott, behavior
insult	insult, imitation, insulting, insults
implant	implant, infection, insertion, injection, implants, instance, invention
kids	kid, kidnapping
aim	aim, action, act, attack, arrow, attempt, aiming, aims, achievement, actions
research	research
mesh	mesh, merge, merger, method, meme, movement, model
smear	smear, slander, sham, slur
root	root, roots
probe	probe, process, probing, procedure, probes, predicate
children	child, crime, children, condition, couple
glory	glory, god
somewhere	sum, state, space
thrill	thrill, threat
mistake	mistake, misunderstanding, miss, mistakes, mismatch, mischief
branch	branch, branching, branches, block, body, bind, borrowing, banking, binding
tower	tower, term, tree, time, theft
triple	triple, tuple, triangle, term, time, times, tri, t, trap
sin	sin
response	response, reaction, reply, responses, riot, responding, respond, resistance, responsiveness, result
family	family, friendship, families, function
radio	radio, recording, relay
co	co, crime, collective, collection, collaboration, cooperative, coercion, condition, conduct, conversion
clot	clot, crime, cascade, contraction, circumcision, condition, cure, consumption
embarrass	embarrassment, error, embarrass, exception, event
select	select, selection, selector, state, selecting, search
orgasm	orgasm, omaly, outburst
success	success, startup, successes, successful
affect	act, action, affect, association, attack, actions
suggest	suicide, statement, suggestion, state, support
when	when, will, while
prefer	preference, protest, prefer, preferred, pace, preferences
thunder	thunder, tornado, time, term, times
heel	heel, hip, hat
lament	lament, latter, loss
w	w, witchcraft, will, work, wit, world
but	body
wheel	wheel, where, will
mention	mention, mentioning, mentions
instruct	instance, instruct, injunction, instruction, invocation
passed	pass, passing, passed, predicate, prohibition, possession, passage
tank	tank, time, term, ting
bad	bad, bug, body
victory	victory, victories
discuss	discussion, dialogue, debate, discuss, discourse, discussions, dispute, definition
company	corporation, company, contract, conduct, companies
overthrow	overthrow, occupation, omaly
did	deed, do, doing, day
heed	homage, honor, heed, hat, hip, harm
substitute	substitution, substitute, subclass, sacrifice, subsidy, service, second, substitutes
dice	die, dice, deed, death
claw	claw, ching, claws, condition, carving
hum	hum, humming, h, heartbeat, harm, ho, how
heaven	heaven, how
each	entity, element, entities, example, expression
breast	breast, breastfeeding, body, breasts, block
Maybe	maybe
penetrate	penetration, process
exceed	excess, exception, execution, exceed, exponential
intensify	
wax	wax, work
bubble	bubble, burst, bounce, bubbles, bust, beta, bb, boom, bub, body
transcend	transformation, transition, transcend, term, time
shoulder	shoulder, shrug, stroke, slap, sum, strike, split
strut	strut, stunt, step, stretching, spectrum
twins	twin, twins, term, time, times
factor	factor, factors, function, fficiency
silence	silence, silent, shutdown, suicide, speech
comfort	comfort, compassion, cure, comforting, condition, convergence
obviously	offense, offence, object
speculate	speculation, speculate, speculative, second
tweak	tweak, time, tweaking, tweaks, tuning, transformation
advocate	advocate, advocacy, association, argument, alliance, act, alignment, activist, agenda, action
pose	pose, posture, poses, posing, position, posed, predicate, problem, provocation, projection
rate	rate, rating, ranking, result
thanks	thanks, thankful, tree, time, term, tuple, times
blaze	blaze, burn, blackout, burning, burns
knows	knowledge, knowing, know
buck	buck, block, bottleneck, body, bang
describe	description, describe, definition, deed
snack	snack, snacks, session, shutdown, sandwich
fork	fork, forks, following, function, first
spark	spark, startup, sparking, sparks, start
specify	state, set, scope
parse	parse, parser, parsing, process, processing, programming
fake	fake, fraud, false, fraudulent, fiction, former
pour	pour, pool, pouring, pint, protest, period, process, poetry
glare	glare, glance, gaze
itself	individual, invocation, instance, ism
price	price, purchase, pricing, prices, period
mom	mother, mom, moms, mothers, merge
Monday	monday, month
chance	coincidence, chance, cure, cause, condition, collision, convergence, conditional
Tony	term, time, tony, tree, transaction, theft, times, thief
export	export, exporting, exit, embargo, exports, example, exchange, exported, exception
realise	realization, recognition, reality, religion, result, revolution
unlock	unlock, unlocking, update, unlocked, upgrade, unlocks
plug	plug, process
stretch	stretch, stretching, stretches
personally	party, property, practice, predicate
nonetheless	
tel	term, time, theft, tree, times, treason
reckon	riot, rebellion, rape, religion, result
week	week, work, weeks, wednesday, weekend
disrupt	disruption, disturbance, disruptive, disrupt, disrupting, disruptions, day, damage, disobedience
administer	act, aggregate, agency, appropriation, arrest, action, abuse, admin, administration, association
smash	smash, smashing, split, smack, slam, strike
person	person, predicate, people, party, persons, population
enlarge	expansion, excess, execution, exponential
before	body, before, beginning, block, behaviour
simmer	simmer, stew, situation, state
Friday	friday, fridays
presume	presumption, predicate, pace
remains	ritual, residual, remainder, refusal, removal
adhere	act, agreement, adherence, alignment, assault, abortion, appropriation, action, adherent, attack
prize	prize, payment, prizes, perty
sheep	sheep, shepherd, slaughter, sow, sacrifice, sum, state
KO	ko, knockout, kick, king, kill, k
distort	distortion, discrepancy, deception, distortions, distort
pardon	pardon, plea, petition, proclamation, phrase, privilege, process
prioritize	priority, prioritize, preference, protest, priorities, priorit, performance, processing, process
el	entity, execution, exception, event, entities
assemble	assembly, assemble, act, aggregate, assembling, association, array, action, aggregation, alliance
seed	seed, sow, seeds, seeded, startup
threaten	threat, threats, term, threatening, terrorism
anymore	act, action, appropriation, assault, argument, abortion, attack, activism
suppose	state, sum, statement
scout	scouting, scout, scouts, search, scope, sow
people	protest, person, people, population, party, predicate
dad	dad, dads, daddy, deed, discipline
crush	crush, crushing, collision, crash, collapse, convergence, compression
crown	crown, ceremony, circumcision, coup
through	through, time, transaction
intersect	intersection, interaction, interface, intersect, instance, invocation, ism
runaway	runaway, rebellion, riot, rape, robbery, regression, result
spear	spear, sword, spears, slash, strike, state, sorcery, stabbing
dissent	dissent, disagreement, demonstration, democracy
audition	audition, act, application, appearance, acting, attempt, atre
stream	stream, streams, streaming
shutter	shutdown, shutter, startup, shooting, shoot, snap
wee	wee, wiping, ww
hitch	hitch, h, hacking, how
rust	rust, rest, rebellion
seat	seat, sitting, seating, session, seats, sit
bottom	bottom, body, block, boycott
flare	flare, fire, fuse, fireball, flares, flash, first, flame
weave	weave, weaving, warp, web, w, witchcraft, woven, work
spray	spray, spraying, spill, splash, shooting, shower
revel	revel, riot, ritual, rave, rebellion, result
stain	stain, spill, stains, smear
big	big, body, business
apprentice	apprentice, apprentices, artisan, act, argument, aggregate, association
U	undefined, union
invent	invention, innovation, inventor, invent, idea, instance, inventions, inflation, invented
moon	moon, moons, magic
remake	remake, remix, reboot, rename, revision, revival, reverse
iron	iron, instance
brood	brood, birth
zoom	zoom
equal	equal, equality, equivalent, egalitarian, entity, exponential, equity, equals
wrap	wrap, wrapping, wrapper, wrapped, wraps
Earth	earth, example, entity, earthquake, event, emission, entities
ease	ease, example, exception, easing, error, event, effect, edge, equivalent
boys	boy, body, boys, bullying, behaviour, block
assassinate	assassination, act, attack, assassin, assault, abduction, ambush
apparently	act, appropriation, action, assault, abortion, attack, assassination, argument, aggregate, atom
condemn	crime, condemnation, conflict, crimes, condemn, corruption, compliance, condemning
couple	couple, coupling
barbecue	barbecue, bbq, body, becue, burger, block, burning, bundle
March	march, month
milk	milk, mother, manufacturing, moment
encounter	encounter, event, exchange, experience, encounters
summon	summon, summoning, summons, sorcery, session, summoned, sacrifice
blitz	blitz, burst, blink, bounce, blocking, bombing, battle, blast
al	act, action, al, attack, assault, arson, appropriation, argument, aggregate, above
seek	seek, search, seeking, sought, seeks, self
Rock	riot, rebellion, relationship, ritual, result, rock
flap	flap, folding, fly, fold, flip, flight, f, flying
stuff	stuff, shit, state
for	function, for, form, functions, following
whatever	whatever, what, will
fuss	first, following
effect	effect, event, entity, effects, entities
duel	duel, dispute, dual
short	short, sum, sentence, stack, second, stop
strive	striving, strive, success, surplus, sin, sacrifice, struggle
occupy	occupation, occupancy, offense, occupying, occupy, ownership
slaughter	slaughter, state
rub	rub, rubbing, ritual, result
bar	bar, body, bill, block, bars, brawl
redeem	redemption, redeem, return, religion, reverse
plea	plea, pardon, pleading, punishment, party, predicate, process, phrase, property
dodge	dodge, dodging, duck, drift, delay, diversion, defense
plant	plant, process, planting, population, period, place, plants, production
DO	do, dom, deed, definition, d, did, does
crop	crop, cultivation, crops, cycle, consumption
since	suicide, sum, state
obsess	obsession, obsessive, omaly, offense
exhibit	exhibit, exhibition, event, expression, exception, example, examples
trans	trans, transition, transgender, transsexual, transformation, term, transient, time, transfer, transform
revisit	revisit, retrospective, reboot, reset, return, rebellion, ritual, reconciliation, religion
flesh	flesh, first
hedge	hedge, haircut, hed, how, hat
house	house, household, home, houses, housing, how
refill	refill, recharge, refresh, ritual, recycling
install	install, installation, installer, instance, implementation, init, installs, installing
snake	snake, sorcery, state, sum, suicide, sacrifice
minister	minister, mp, ministry, ministerial, merger, minority
remind	riot, rape, rebellion
percent	percentage, protest, percent
human	human, humanity, humanoid, humans, hybrid
ignore	ignore, ignoring, indifference, ignored, infringement, instance, ignores, ignorance
kind	kindness, kind
fell	fall, failure, felony, first, former, following
alright	act, action, assault, abortion, attack, appropriation, arrest, argument, above
calm	calm, crisis, calming, condition
usually	union
retake	riot, rape, rebellion, result
justice	justice
filter	filter, filtering, filters, filtered, flow, fragment, function
brown	brown, black, body, burning
analyze	analysis, act, action, alyses, analyze, argument, attack, accusation, appropriation, actions
quarrel	quarrel
treat	treat, term, tax, treatment, treating, time, theft, trade, trick, t
interact	interaction, interface, instance, interact, interactions, imitation, ing
accidentally	accident, act, accidental, arson, assault, attack, alias, assembly
birth	birth, beginning, birthday, births
scratch	scratch, scratching, scrape, scratches
aspire	act, aspiration, action, ambition, aspiring, appropriation, achievement, apology, assault, association
Wrestle	
or	offense, orem, offence, option, or
comeback	comeback, coup, cure
trespass	trespass, theft, tresp, threat
sack	sack, state, sacks, strike, sum, slavery, such
retain	retention, riot, rape, rebellion, retain, remainder, return
issue	issue, incident, instance, issues, infringement
vacation	vacation, vacations, visit
grasp	grasp, grasping, grab, grip, gesture, grabbing, get
recap	riot, result, rebellion, robbery
plunge	plunge, place, period, process, practice
butt	butt, buttocks, block, body, back, bust, bum
mold	mold, mutation, mould, manufacturing, modification, modeling, making, mash
ash	ash, accident, apocalypse, arson, act, avalanche, atom, ashes
great	great, greatness, genius, good, greatest, growth
grade	grading, grade, grades, gpa, graded
label	label, labeling, labels, list, latter
master	master, mastery, magic
certainly	crime, case, collection, convergence, constitution
link	link, linking, linkage, lock, links, latter
credit	credit, credits, charge, collection
dose	dose, dosage, drug, day, delta, d, doses, diagnosis, deficiency
attract	attract, attraction, attracting, act, affinity, attack, association, argument, attracts, attractiveness
jet	
Jack	jack
tag	tag, tagging, tags, tagged, tick, ting
fool	fool, fraud, folly, fallacy, fools, following, first
rotate	rotation, rotate, rotating, result
mislead	mislead, misleading, mistake, murder
uphold	union
pit	pit, pool, pace, pie, phase, paradox, pair, predicate, place, pile
Read	rape, riot, result, religion
egg	egg, event, eggs, easter, embryo, execution, example
naturally	natural
degrade	degradation, disaster, decay, degrade, down, damage
pulse	pulse, pace, pulses, process, processing
tap	tap, tapping, timeout, taps, token, touch, time, transaction, tattoo, technique
number	number, numbering
deter	deter, deterrent, deterrence, divergence
action	act, action, argument, accusation, actions, attack, activism
ramp	ramp, resistance, ritual
others	offense, offence, order, other
owe	owed, owe, owing, obligation, offense, offence
completely	crime, complete, condition, corruption, case, conversion
exactly	execution, entity, entities, event, example, exponential, expression
overturn	overturn, outcome, offense, order, ordering
dwarf	dwarf, double, deed, deficit
injury	injury, insult, infection, illness, injured, injuries, incident, injure
advertise	advertisement, advertising, ad, advert, act, advertise, appropriation, affiliate, advertisements, above
cow	cow, calf, cows, collection, cattle, condition
breath	breathing, breath, burst, body
pant	pant, pace, practice, paradox, predicate, poverty, protest, purge
gossip	gossip, gate
parade	parade, procession, protest, party, period
purchase	purchase, purchasing, purchases, price, period, process
differentiate	differentiation, distinction, difference, divergence, divide, definition, deed
bastard	bastard, body, betrayal, blasphemy, block
pen	pen, poetry, poem, pencil, predicate, pid, process, pace, point, place
scrap	scrap, split, scrape, surplus, swap, scraping, strike, stripping, sum, sale
combine	combine, combination, composite, cluster, collection, coupling, crime, corruption
Mars	martian, mars, merger, miracle, magic
amount	amount, act, appropriation, addition, aggregate, action
grind	grind, grinding
recently	riot, rebellion, recent, recently, return
bully	bully, bullying, boycott, bullies, bull, behavior, body, behaviour
PR	pr, promotion, process, publicity, pace, predicate, property
bank	bank, banking, banks, branch, balance
Phoenix	prayer, pair, predicate, pace
display	display, demonstration, displays
November	november
missed	miss, missing, missed, misses, mismatch, murder, mistake
inside	instance, initiation, invocation, inside, index, interface, id, ing, iling, itation
extend	extension, extend, end, expansion, example, extends
moderate	moderate, moderation
moment	moment, moments
swat	swat, state, sum, strike, slap, speech
whiff	whiff, wit
guys	gang, game, guys, group
changed	change, changes, conversion, changing
years	year, years
damage	damage, destruction, disturbance, disruption, damages, disaster
ban	ban, boycott, banning, block, blacklist, bans, blocking, blockade, body
his	hip
almost	act, action, appropriation, argument, attack, abortion, assault, aggregate, array, above
Do	do, deed, doing, definition
cater	crime, cater, cat, corpus, convergence, category, condition, case
process	processing, process, processes, pace, procedure, project
brief	body, brief, block
cluster	cluster, clusters, collection, computation, chain
motivate	motivation, motivate, motive, motivating, motiv, motivated, motivational
mess	mess, mistake, mismatch, mix, mischief, messy
coordinate	coordinate, coordination, cluster, convergence, constellation, computation, calculation, chain
infiltrate	infiltration, intrusion, infiltrate, invasion, intruder, infection, incident, infiltr, iltration, interference
deceive	deception, deceit, deceive, dece
LOL	list, laughter, latter, law, laugh
bang	bang, boom, block, bump, body, banging, bomb
wow	
scare	scare, scares, scam, scenario, situation
illuminate	illumination, illuminated, illuminating, image, invocation, ism
amplify	amplification, act, amplify, avalanche, attack, amplified, action, appropriation, assault, abortion
exchange	exchange, export, event, example, exchanged, exchanges
overwhelm	overload, overwhelm, overflow, overwhelmed, overloaded, overlap, outburst, overdose
of	offense, offence, of
pivot	pivot, place, pace
glitch	glitch, glitches, game
decode	decoding, decode, data
blend	blend, blending, blends, blended, body
contact	contact, communication, call, conversation, callback, contacts, contacting
bury	burial, burying, body, bury
broken	broken, break, block, breach, breaking, body, broke, breaks, bind, binding
monitor	monitor, monitoring, monitors
ticket	ticket, tickets, transaction, term, time, tree, times, tuple, taxation
prick	predicate, pair, pace, possession, piercing, place
season	season, seasons
transplant	transplant, transition, transfer, transformation, treatment, term, time, termination
GO	go, gc, goal, get, game, g
food	food, feast, famine, fork, foods, function
is	invocation, instance, is, intention, integral, ism, ing, instances
subpoena	subpoena, search, seizure, statute, subpoen, surveillance
drill	drilling, drill, day, dig, dip, drills
login	login, log, logging
lap	lap, laps, loop, lane, law, latter
deepen	divergence, deed, depth, deepening
shy	shy, smile, situation
error	error, exception, err, errors
gorge	
Lord	lord, law, latter
sled	state, sum, strike
alive	act, action, activity, acting, abortion, alive
Not	null
evade	exception, evasion, evade, escape, execution
drain	drain, default, diversion, deed, drowning, day, draining, drains, drainage
Jeff	
flight	flight, flying, fall, flights, function, first, flow
b	b, body
crib	crib, circumcision, collection, comma, child, construction, condition, contract, cutting, crime
trail	trail, trace, tracking, time, tail, trailing, track, thread, trails, term
cream	cream, condition, collision, cooking, cake, case, cycle
squat	squat, squats, swamp, situation, stall, sum
Steve	suicide, state, sum, sacrifice, steve
ex	ex, end, exp, exception, example, event, e, exile, est, expulsion
ed	ed, education, entity, entities, example, e, event, exception, educator, expression
everything	entity, exception, event, entities, example, everything
hook	hook, hooks, h, hip, hacking, hack, hing, how, hell
inquire	inquiry, investigation, interview, invocation, instance, inquire, inquiries, ism
NEVER	
comprehend	comprehension, crime, concept, cognition, ception, conversion
sport	sport, sports, season, state
slash	slash, slashing, slice, sword, split, strike, sacrifice, stab, slicing
promote	promotion, promoting, promoter, promote, profit, practice, protest, propaganda, prostitution
bag	bag, bags, body, boycott, bage
least	law, least, latter, list, lessness, lot, loss, last
church	church, conversion, confession, christianity, churches, collection
port	port, ports, piracy, process, porting, period
attach	attach, act, attachment, attaching, appropriation, aggregate, association, ap, attached, addition
woo	woo, wedding, witchcraft, wing
swap	swap, shift, switch, split, swapping, swaps
blue	blue, body, block, boolean, black
ok	ok, omaly, offense, offence, oning
trouble	trouble, threat, time
ten	ten, term, tree, time, tuple, times, tenth
endorse	endorsement, endorsing, election, endorsements, endorse
may	may, might, must
grown	growth, generation, gift
appropriate	act, appropriate, action, appropriation, allocation, assignment, above, acting
S	s, sum, sin, subset, state
Rebel	rebellion, riot, rebel, resistance
phase	phase, period, phases, process, processing
throttle	timeout, throttle, time, technique
loss	loss, losses, latter, lose
sip	sip, session, spill, second, smoking, swearing, spitting
condition	condition, conditional, case, conditions, contract, change, crime, construction, conditioning
meltdown	meltdown
dash	dash, delta, driving
forward	forward, fork, forwarding, future, function, first
would	will, would, wish
friend	friend, friendship, friends, friendly
Greg	
honey	honey, how, hive
old	old, object
rarely	riot, rape, rebellion
reconstruct	reconstruction, reconstruct, reconstructed, recovery, regression, result, revolution
case	case, cases, crime, condition, conditional
fails	failure, fail, failing, fails, failures, failed, fault, function, fraud, first
t	t, tuple, term, tort, tail, time, termination, ting, tant
few	few, function, first
early	execution, event, entity, exception, example
sure	sum, state, sure, sin
abuse	abuse, assault, abuser, abduction, act, attack, addiction, accusation, above
adventure	adventure, adventurer, act, action, activity, achievement, adventures, activities
pencil	pencil, pen, process, predicate, pace, place
captain	captain, command, combat, collection, condition
harass	harassment, harass, harassing, hat, harm
punk	punk, protest, prank, partition, pace, predicate
round	round, rounding, roll, rounds, rectangle, result
directly	deed, definition
compost	compost, cess, consumption, collection, condition, cleaning, cooking, cycle
prod	protest, prod, phase, process, pace, place
squeeze	squeeze, squeezing, squeezed, sum, squee, stretching
farewell	farewell, funeral, former
fray	fray, first, following
everyone	equality, entity, egalitarian, exception, event, example, effect, entities
vest	vest, violence, vote, val, value, vandalism
hammer	hammer, h, hit, hat, hing, harm, hacking
shape	shape, structure, sculpture, silhouette, sphere, shaping, symmetry
failure	failure, fail, failing, failures, fault, failed, fails, former, first
dial	dial, delay, default, draft
Tell	term, time, tree, theft, tuple, times, treason, terrorism
employ	employment, employ, employer, employing, employed, exploit, employee, entity
validate	validate, validation, valid, verification, value, violation
pro	pro, predicate, pair, possession, protest, petition, property
within	within, where, work
chop	chop, chopping, cutting, cut, chopped, chunk, carving, comma, cooking
grip	grip, gesture, grasp, grasping, grab, gripping, grapple
journal	journal, journalism, journals
quiz	quiz, question
team	team, teamwork, teams, time, times, task, tuple
poison	poison, poisoning, poisoned, plague, poisons, process
sentence	sentence, speech, sentences, statement, sum
induce	induction, induce, instance, illusion, induced, imitation, inducing, infection, initiation, invocation
voice	voice, voices
amp	act, aggregate, appropriation, argument, action, assault, attack, array, amp, above
ret	riot, rebellion, rape, result, runtime
sick	sickness, sick, suicide, shutdown, season
green	green, gray, garden
audit	audit, auditor, act, audits, accounting, above
ry	r, rape, rite, rebellion, riot, revolt, result, resistance, ritual, root
incite	inciting, incite, insurrection, incident, itement
Go	go, game, get
confront	confrontation, conflict, clash, crisis, confront, crime, challenge, collision
bleach	bleach, breach, bath, boil, body
worm	worm, warp, worms, weaving, work
ta	ta, term, tuple, time, t
Rule	rule, rules, ruling, result
haha	hat, how, h, hacking, hing, hack
quiet	quiet
crowd	crowd, convergence, clash, concert, chant, combination
lick	lick, licking, le, luck, latter, love
inevitable	inevitable, impossibility, instance, impossible
model	model, modeling, modelling, models, module, method
overflow	overflow, overload, overflowing, operation, overfl
Pop	protest, pace, pair, predicate
twice	tuple, theft, time, times, term, treason
counsel	counsel, conduct, consultation, coalition, counselor
treasure	treasure, theft, term, thief, transaction, trade, time
album	album, act, artist, autobiography, artwork, appearance, argument, albums, aggregate, art
render	render, rendering, result, return
undo	undo, undone
future	future, function, former
forgotten	forgetting, forgotten, forget, former, forgiveness
thereafter	term, theft, treason, time, terrorism, tree, times
Twitter	tweet, twitter, tweeting, troll, tweets, time, term, tree
award	award, act, awarding, awards, achievement, acceptance, acknowledgement, appreciation, awarded
air	air, act, airplane, atom, anomaly, ascent, action, aircraft, aviation
implement	implement, implementation, instance, implementing, implementations
rig	rig, robbery, result, rigging, riot
instantly	instance, infringement, invocation, instant, ism, instances
chain	chain, chains, cascade, cycle
pine	partition, pace, process, predicate, practice, pine
cage	cage, crime, corpus, condition, collection, ching, coercion
warp	warp, weaving, work, worm
ferment	fermentation, ferment, flood, first
medal	medal, medals, match, manship, multiplier
blood	blood, bath, bleed, bleeding, body
hour	hour, hours, how
correspond	crime, correspondence, complement, connection, correlation, case, corruption, coercion, conversion
drunk	drunk, drinking, dui, drunken, drink, drinks
inject	inject, injection, injected, injecting, instance, invocation, infection, intercept, initiation, ing
page	page, pages, poem, phase, plot, process
amuse	amuse, act, amusement, argument, aggregate, association
scramble	scramble, scrambling, second
revolution	revolution, rebellion, revolt, revolutionary, riot, revolutions, resistance
happy	happy, happiness, happiest, h, holiday, how
less	less, lessness, latter, loss, lot
populate	pace, protest, period
o	o, offense, object, order
shutdown	shutdown, standoff, spending
limit	limit, limitation, limits, law, latter, limiting, legislation, limitations
pan	pan, panic, paradox, prank, pot, parody, process
sand	sand, sandbox, swamp, stone, sands, straw
er	execution, entity, exception, event, example, entities
grant	grant, gift, grants, granting, giving, given, give
surgery	surgery, surgical, sis, stroke, shift, session, split, state
bullet	bullet, body, block, bullets, bundle
kickoff	kickoff, kick, kicking
Know	
jazz	jazz, jam
exhaust	exhaust, exhaustion, end, exception, emission, event, excess, exit, explosion, expiration
widen	widening
O	o, offense, operation, object
five	five, first, function, fifth, following, four, felony
ov	ov, offense, operation, omaly, o, oning
respect	respect, relationship, recognition, respects, reciprocal
entirely	execution, entity, exception, entities, empty
publicly	public, publicly, protest, private, parency, piracy, party
shuttle	shuttle, split, swap, shipping, second
transgress	term, transgress, theft, trust, treason
must	must
borrow	borrow, borrowing, borrowed, borrower
tears	tear, tears, tearing, tornado, time
Rise	rise, rebellion, rising, revolution, revolt, resurrection, result, resistance
recount	recount, recounts, recovery, referendum, record, reconciliation, review
Christian	christian, conversion, christianity, confession, convert, christians, covenant, cross, condition
max	max, maximum, min, multiplier, murder
diet	diet, day, deficit, deficiency, diets, disease, days
wet	wet, waterfall, water, washing, wash, watering
il	instance, interval
brush	brush, brushing, blur, bump, burn, boundary, brushes
and	act, appropriation, action, adultery, argument, agreement, array, aggregate, above
pink	pink, purple, protest, party, prank, pace
reassure	riot, rape, reassure, response, result
reiterate	riot, rape, rebellion
streak	streak, sequence, spike, suicide, stretch, streaks
poke	poke, poking, peek, poked, pace, ping, prank, punch, process, phase
bunk	bunk, body, block, burglary
yourself	
Israel	invasion, israel, illegal, israeli, idf
interest	interest, inquiry, investigation, interests, investment, instance
limp	limp, lag, loop, latter, leep, load, luck
class	class, classes, crime, conflict, classification
Follow	following, function
app	app, application, api, action, act, attack, argument, array, apps
gay	gay, gays
pace	pace, pacing, progress, performance, period, process
recognise	recognition, recognise, reconciliation, respect
stock	stock, sale, share, s, selling, security, sum
should	should, shall, same
lunch	lunch, latter
things	things, transaction, time, term, thing, times
pastor	pastor, preaching, priest, prayer, priesthood, pastors, partition, pace, period
hop	hop, hops, ho, hopping, h, how, hat, hip
soil	soil, state, swamp, space
quite	
sup	state, sum
much	murder
correlate	correlation, cluster, correlate, convergence, coincidence, causation, crime, coercion, corruption, cult
bites	bite, bites, biting, bitten, behavior, body
animate	act, animate, animation, action, anim, acting, animated
tan	tan, tattoo, transition, term, time
contain	collection, component, class, crime, coercion, conversion, corruption
waste	waste, wasting, wastes
hem	homicide, holocaust
crew	crew, craft, cycle, crews, construction, captain
stagger	stagger, suicide, sum
Trump	tweet, treason, term, transition, threat, tie, trump, time
toss	toss, throw, tossing, transition, throwing, term, termination, trash, tossed, trade
DC	dc, decision, dmca, day
rampage	rampage, riot, rape, rage
thought	thought, time, thinking, term, thinker, theory
redesign	redesign, revision, renovation, restructuring, rewrite
simply	state, sum, statement, second, same
hij	homicide, holocaust
divest	divest, dissolution, decline, date, days, deed, day, da
reclaim	reclaim, return, rebellion, revolution, resistance
target	target, threat, targets, time, targeting, term
career	career, careers, cycle
gladly	
happened	how
dip	dip, drop, decline, dipping, delta, down, derivative, dab
