die	death, die, dying, dead
win	winning, win
be	
survive	survival, surviving, survive
fail	failure, fail, failing, failed, fails
succeed	success, successful
live	life, live, living
pass	pass, passing
do	do
cry	crying, cry
know	know, knowledge, knowing
fall	fall, falling, falls, fell, fallen
work	
leave	leave, leaving
not	
come	come
return	return, returned, returns, returning
lose	lose, loss, losing, lost
stay	stay
bite	bite, biting, bitten
tell	the, this, that
answer	a, answer
try	try, this, that, test
explode	explosion, explosive, exploding, explode, exploded
disappear	disappearance, disappear, disappearing
go	go, going
fly	flying, fly, flight
happen	happen, happened
help	help, helping, helpful
run	run
respond	response, respond, responding, retaliation
sue	sue, sued, suing
change	change
remember	remember, remembering, recall
last	lifetime, last, life
too	this, that
eat	eating, eat
have	
listen	listening, listen
pay	payment, pay
miss	miss, missing, mistake, missed, misses
understand	use, usage, understanding, using
retire	retirement, retire, retired
suffer	suffering
see	see, seeing
talk	talk, talking, this
recover	recovery, recover, recovering, recovered
starve	starvation, starving, starve
learn	learning, learn
say	
wait	wait, waiting, waits
stop	stop, stopping
scream	scream, screaming, shout, screams, sound
remain	reuse
finish	finish, finishing, finished
rise	rise, rising
break	break, breaking, broken, broke
follow	following
quit	quitting, quit
lie	lying, lie, lies
disagree	disagreement, disagree, dispute
graduate	graduation, gpa, graduate
burn	burn, burning, burned, burns
end	end, ending
laugh	laughter, laugh, laughing
strike	strike, striking, strikes
smile	smile, smiling
hurt	hurt, harm, hurting
call	call
walk	walking, walk
deliver	delivery, deliver
ask	ask, asking, a
prevail	power
stick	stick, sticky
sleep	sleep, sleeping
apologize	apology, apologizing, apologize
explain	
kill	kill, killing
perish	perish
write	write, writing
vomit	vomit, vomiting
speak	speech, speak, speaking, speaker
fold	fold, folding, folds, folded, flex
agree	agreement, agree, agreed, agreeing
drown	drowning, drown, drowned, death
suffice	
care	care, caring
resign	resignation, resign
exist	existence, exist, exists
teach	teaching, teach, teacher, this
never	never
testify	testimony, testifying, testify, truth
collapse	collapse, chaos, collapsing
vanish	vanishing, vanish
protest	protest
decide	decision, deciding
triumph	triumph
sing	song, singing, sing
stand	standing, stand
rest	rest, resting, rested
count	count, counting
drink	drinking, drink, drunk
continue	continuation, continue
crash	crash, crashing, crashes, crashed
escape	escape, escaping, exile, escapes
fight	fighting, fight
heal	healing, heal, healed, heals
blink	blink, blinking, blinked
soon	
show	
refuse	refuse, refusal, refusing, resistance
choose	choice, choose, choosing
move	move, motion, movement, moving
watch	watch, watching
shine	shine, shining, success, star, shines
matter	meaning
think	thinking, think, thought, this, that
now	now, new
emerge	emergence
grow	growth, grow
visit	visit, visitor, visiting, visited, visitation, visits, visitors
play	play, permission
fit	fit, fitting
suck	suck, sucks, spam
burst	burst, bursting, bubble, breakout
notice	notice, noticing
fade	fade, fading, flame
bleed	bleed, bleeding, blood
again	abuse
share	sharing, share, shared
arrive	a
anyway	abuse
cave	cave
weep	weeping, weep
rebel	rebellion, rebel, revolt
bail	bail, bond
forget	forget, forgetting
read	read, reading
bolt	bolt
retaliate	retaliation, retaliate, revenge
reply	reply, response, respond, replies
crack	crack, cracking, cracked, code
rule	rule, rules
resist	resistance, resist, resisting
appear	appearance, a
appeal	appeal, abuse
disappoint	disappointment, disappointing, disappointed, disappoint
me	misuse, meme
freeze	freeze, freezing, frozen, freezes, froze
pop	pop, popping, popped, pops
sell	sale, selling
shoot	shooting, shoot, shot
eventually	
pray	prayer, pray, praying
drive	driving, drive
take	take, the, this
land	land, landing, landed, launch
complain	complaining, complain, complaint, criticism
thrive	
struggle	struggle, struggling
start	start
stink	stink, smell
turn	turn, this, turning
comply	compliance, comply, coercion, complying
lead	lead, leadership, leader, leading, led
succumb	
hope	hope, hoping
ever	
expire	expiration, expired, expire, expires
hit	hit, hitting
choke	choking, choke, choked
persist	persistence, persistent, persist
vote	voting, vote
make	make
confess	confession, cheating, confessions
snap	snap, snapping, snapped
evolve	evolution, evolve
match	match, matching, matches, matched
approve	approval, approve, authorization, approving
give	give, giving, gift, given
melt	melt, melting, melted, melts
endure	endurance
marry	marriage, marry, marrying
crumble	crumble, collapse
decline	decline, death
always	always, a
publish	publish, publication, publishing, permission
serve	service, serve, serving, served
manage	management, manage, managing, managed
tweet	tweet, twitter, tweeting, this
close	closure, close, closing, closed
march	march, marching
though	this, that, the
hear	hear, hearing
someday	
react	react, reaction, response
sign	signature, sign, signing
look	look
kiss	kiss, kissing, kissed, kisses
intervene	intervention, intervene, intervening, it, interference
ride	riding, ride, rider
perform	performance, perform
obey	obey
hold	holding, hold, holds
settle	settlement, settling, settle
revolt	revolt, rebellion, resistance
drop	drop, dropping, dropped
join	join, joining
slip	slip, slipping, slipped, slips
attack	attack, attacking, attacks, attacked, abuse
believe	belief, believe, believing
travel	travel, transportation, traveling, teleportation, tourism, transit, this
attend	attendance, a, attending
sink	sink, sinking, sunk
improve	improvement, innovation, improve, it
argue	argument, arguments, arguing, argue
guess	guess, guessing, guesses
reconsider	
cook	cooking, cook
please	permission
worry	worry, worrying
object	object, objects
qualify	qualifying, qualification
post	post, posting
judge	judging, judgment, judge
volunteer	volunteering, volunteer
erupt	explosive, eruption, explosion, erupt, exploding
mourn	mourning, mourn
next	next
relapse	relapse, recovery, remission
rock	rock
faint	faint
cooperate	cooperation, cooperate, cooperating, cooperative, collaboration, coercion, collusion, coordination
nap	nap
propose	proposal
get	
convert	conversion, convert, converting, conversions, converted
yield	yield
benefit	benefit
regret	regret
act	action
fry	fry, frying, fried, fish
pee	pee, poop, piss
flee	fleeing, flee, flight
comment	comment, commenting, comments
flip	flipping, flip, flipped, flips
confirm	confirmation, confirm, confirming
ship	shipping, ship
bloom	bloom, bud
mind	mind
adapt	adaptation, adapt, adaptive, adapting
yet	
fire	fire, firing, fired
dance	dance, dancing, drag
compete	competition, cheating, competitive
shout	shout, shouting, scream
report	report, reporting, reported, reports
wonder	wonder
bomb	bomb, bombing
pull	pull, pulling
bounce	bounce, bouncing, bounces
save	save, saving, saved, saves
dominate	dominance, domination, dominant, dominating, dominate
buy	buying, buy
blow	blow, blowing, blown
belong	belong, belonging, belongs
hang	hang, hanging, hung, hangs
accept	acceptance, accepting, accept, a
sting	sting
shrink	shrink, size, shrinking, shape
slide	slide, sliding, slip, slides
participate	participation, participating, participate, permission
meet	meet, meeting, met
spread	spread, spreading, spam
you	
jump	jump, jumping, jumps, jumper
insist	it
leak	leak, leaking, leakage, leaks, leaked
rot	rot, rotation
rebuild	rebuild, rebuilding, recovery, reuse, restore, reboot, restoration
check	check, checking
occur	
cease	cessation, cease, ce
apply	assert, a
panic	panic
keep	
find	find
pick	pick, picking
bark	bark, barking
tomorrow	this, that
today	today, this
connect	connection, connect, communication, connectivity, connecting
linger	linger, lingering, ling
hesitate	
admit	admitting, admission, a, admit
surrender	surrender, submission
smoke	smoke, smoking
arise	arise, a
tonight	this, that
indeed	it
feast	feast, famine, food
bitch	bitch
release	release, releasing, releases
bake	baking, bake, baked, bread, bakery
pitch	pitch, pitching, pitches, pitched
prosper	profit
swear	swearing, swear, slang
blog	blogging, blog, blogger
contribute	contribution, contributing, contributions, contribute
yell	yell, yelling
promise	promise, promises, promising
sit	sitting, sit, seating, standing, sat, space
shave	shaving, shave
adjust	adjustment, adjust, adjusting, adjusted
fuck	fuck, fucking
shatter	shatter, shattering, shattered
Die	die, death, dying, dead
dream	dreaming, dream
execute	execute, execution, executing
elaborate	elaborate
right	right
out	out
behave	behavior, behaviour
maybe	
destroy	destruction, destructive, destroy
swallow	swallow, swallowing, spit
rain	rain, rainfall
test	test, testing, tests, this, that
knock	knock, knocking, knocked
rally	rally, rallying
regress	regress, regression, r
prove	proof, prove, proving
buckle	buckle, belt
suit	
hide	hiding, hide
then	that, this, the
study	study, science
swim	swimming, swim, stroke
inherit	inheritance, it, inherit
reign	reign
regenerate	regeneration, regenerate, resurrection
retweet	retweet
clarify	clarification, clarify
cross	crossing, cross
submit	submission, submit, submissions, submitting, submitted
beg	begging, beg, bribery
need	need
whine	whine, whining
relent	
donate	donation, donating, donate
later	
exit	exit, escape, exiting, end, exits
draw	drawing, draw
investigate	investigation, investigate, investigating, it, investigative, intelligence
click	click, clicking, clicked
himself	
beat	beat
celebrate	celebration, celebrating, celebrate
surprise	surprise, shock
depart	
wake	wake, waking, woke
spill	spill, spilling, spilled, spills
soar	soaring, success, soar
cheat	cheating, cheat
point	point, pointing, pointer, points
open	open, opening
cope	coping
wander	wandering, wander
probably	
begin	beginning, begin
repeat	repeat
kick	kick, kicking, kicked, kicks
freak	freak
tire	tire, tires, tyre, this
enter	enter, entry, entering
forever	forever
stumble	stumble, stumbling
translate	translation, translate, translating, translator, translated
battle	battle
feel	feeling, feel
also	a
concede	cheating
split	split, splitting
cure	cure, cancer
surface	surface
catch	catch, catching, capture
coach	coaching, coach
climb	climbing, climb
back	back
date	date, dat, day
register	register, registration, registering
want	want
poop	poop, pee
pause	pause, paused, pauses
enlist	enlist, enlisted
switch	switch, switching, swap, switches
plead	pleading
either	
cover	cover, coverage, covering, covered, covers
spring	spring, springs, sprung
hate	hate, hateful, hatred, hating
toast	toast, this
race	race, racing
repent	repentance, repent, redemption
experiment	experimentation, experiment, expression
form	form, function
kid	
balk	
develop	development
merge	merge, merging, merged, merger
still	
Fall	fall, falling
score	score, scoring, success
inspire	inspiration, inspiring, inspire, inspirational, inspired, it, influence
question	question
feed	feed, feeding
clean	clean, cleaning, cleanup, cleaner, cleansing
excel	excel, excellence, efficiency
snow	snow
jail	jail
account	abuse, account
rejoice	rejoice
apologise	apology, abuse
rebound	rebound, recovery
rap	rap, rapper
recognize	recognition, recognize
err	err, error
roar	roar, roaring
correct	correct, correction
shift	shift, shifting
commit	commit, commits
blame	blame, blaming
here	here, hash
become	
shut	shutdown, shut
recall	recall, remember, recalled, recalling
trip	trip, this, that, tri
ascend	ascend, ascent, ascended
rank	rank, ranking, rating
I	i, it
wear	wear, wearing
roll	roll, rolling, rolled, rolls
love	love, loving, like
nod	nod, nodding
flourish	flourish
figure	
transform	transform, transformation, transforming, transforms, transformations
died	death, die
steal	stealing, steal, stolen
launch	launch, launching, launcher, launched
refrain	refrain
flood	flood, flooding, floods, flooded
death	death
interfere	interference, interfere, interfering, influence
bed	bed
attest	abuse
shrug	shrug, slang
expand	expand, expansion, expanding, expanded
breathe	breathing, breathe, breath
float	float, floating, floats
cut	cutting, cut
wink	wink, wit
conform	conform, compliance, conformity
first	first
star	star, stars
disperse	disperse, dispersed
ruin	ruin
produce	
demonstrate	demonstration, demonstrate, demonstrating
cancel	cancel, cancellation, cance, canceled, cancelled
swing	swing, swinging, swung, swings, slash
him	he
terminate	termination, terminate, terminating, terminated, termin, this
result	result
dissolve	dissolution, dissolve
smell	smell, scent, stink, smelling
note	note, notation
identify	identifier, it, identification, identify
bet	bet, betting
preach	preaching, propaganda
ring	ring, ringing, rings
edit	edit, editing, edits
wish	wish, wishes, wished, wishing
despair	despair, depression, distress, darkness
differ	difference, definition
like	like
hunt	hunting, hunt, hunted, harvesting
collect	collection, collecting, collect, collected, collections
set	set
spawn	spawn, spawning, spawned
cough	cough, coughing, choking
finally	
awake	awake, awakening, awaken, activation
deploy	deploy, deployment, deployed, deploying
push	push, pushing, pushed
instead	it
glow	glow, glowing
plan	planning, plan, permission
dead	dead, death, die
joke	joke, joking
mean	meaning
bond	bond, bonding, binding, bonds, borrowing
forgive	forgiveness, forgive, forgiving
us	use, usage
camp	camp, camping, camps
well	well
Tweet	tweet, twitter, this, tweeting
claim	claim, claiming
haunt	haunt, haunting
use	use, usage, using
only	
resonate	resonance
direct	direct, directing
shop	shop, shopping
actually	a
grin	grin, grinning
leap	leap, leaping, leaps
focus	focus, focusing, focused
state	state, statement
mine	mine, mining, mined
loose	loose
command	command
prison	prison, possession
really	
age	age, aging, aged
in	it
reveal	revealing, reveal
cheer	cheer, cheering, cheers, cheered
escalate	escalation, escalate
enroll	enrollment, enroll
wreck	wreck
provide	
witness	witness, witnessing, witnesses
print	print, printing, permission
prosecute	prosecution, possession, prosecute, prosecuting
touch	touch, touching, that, this, touched
overdose	overdose
blush	blush
will	will
send	send, sending, sender
revert	revert, reverted, reversal
withdraw	withdrawal, withdraw, withdrawing
carry	carry, carrying, carried, carries
default	default, defaults
train	training, train, trainer, this, that, trained
bend	bend, bending, bent
practice	practice, performance, practicing
slay	slaying, slay
whistle	whistle, whist
tie	tie, tying, tied
failed	
sew	sewing, sew, stitch
ski	ski, skiing, snow, slope
subscribe	subscribe, subscription, subscribing, subscribed
awaken	awakening, awake, awaken, awakened, activation
it	it
dare	dare, daring, dared
already	a, already
slow	slow, slowdown, speed, slowing, slower
debut	debut
tear	tear, tearing, tore, this, tears
shortly	
interrupt	interrupt, interruption, interrupts, interrupted, it
clash	clash, conflict
deal	deal, dealing
nurse	nursing, nurse
fragment	fragment, fragmentation, fragments
better	better
build	build, building
child	cheating
one	one
soften	soften
fast	fast, faster, fastest
attempt	attempt, a
punch	punch, punching, punched
power	power
overcome	overcoming, overcome
sweep	sweep, sweeping, sweeps, swept
book	book
respawn	respawn, resurrection
curse	curse, cursing, curses, cursed
charge	charge, charging, charged
rip	rip, ripping, ripped
relate	
disarm	disarm
whisper	whisper, whispering, whispered
let	let
transfer	transfer, transferring, transfers, this, transferred, transit, transaction
increase	increase, it
gain	gain
chuckle	chuckle, comedy
swell	swell, swelling
multiply	multiplication, multiply
pump	pump, pumping, pumped, pumps
murder	murder
morph	morph, morp, meme
part	part, parts
update	update, use, updating, updates, updated, usage
left	left
double	double, doubling
combust	combust, combustion
fracture	fracture, fracturing, fractured, fragmentation
retreat	retreat, retreating
realize	
dry	dry, drying
wave	wave, waves, waving
spoil	spoil, spoiled, spoiler, stealing
sweat	sweat, sweating, sweaty
relax	relaxation, relaxing, relax, relaxed
text	text, this, type
bear	bear
reconcile	reconciliation
swarm	swarm, stalking
collaborate	collaboration, communication, collaborating, collaborate, collaborative, cooperation
reverse	reverse, reversing, reversal
cost	cost
block	block, blocking, blocks
black	black
thank	thanking, thank, thanks, this, thanked, the
declare	declaration, declare, declared, declaring
own	ownership, owner, owning, owned
experience	experience
adopt	adopt, adopting, adoption, adopted, appropriation
advance	advance, advancement
complete	completion
descend	descent, descend
function	function, functions, functionality
step	step, stepping, steps
announce	announcement, announce, announcing, a
reload	reload, redirect
add	add, a, adding
skate	skate, skating, speed, sk
spike	spike, spikes, spiked
resolve	resolve
up	up, use, usage
assist	assist, aid, assistance, assisting
boy	
dies	death, die, dies, dying, dead
chill	chill, chilling
search	search, searching
offer	offer, offering
measure	measurement, measure, measuring, metric, measurements
spit	spit, spitting, spat, saliva
profit	profit
bow	bow
eject	eject, ejected, escape, exploding
shed	shed, shedding, sheds
bust	bust, block
jam	jam, jammed
corrupt	corruption, corrupt
wipe	wipe, wiping, wipes, wiped
cringe	cringe
sigh	sigh, slash
veto	veto, voting
scar	scar
plummet	
cycle	cycle, cycles
scatter	scatter, scattering, spat, spam, spread, spreading
wrestle	wrestling, wrestle, wrestler, wrest
indict	indictment, indict, impeachment, it
hurry	hurry, haste
disapprove	disapproval, defamation
game	game, gaming, gameplay
fart	fart, feces
hire	hiring, hire, hired
compensate	compensation, compensate
assume	assert, a, assumption, assume
signal	signal, signaling
sacrifice	sacrifice, sacrificing, slavery
suspect	
prepare	preparation, prepare, preparing, prep, prepared, planning
stir	stir, stirring, stirred
relocate	relocation, relocate
roast	roast, roasted
lapse	lapse
free	free, freedom, freeing
somehow	
topple	this, topple
tour	tour, touring, tours, this
offend	offensive, offend, offense
sail	sail, sailing, sails
hatch	hatch, hatched
rant	rant, rage
fish	fishing, fish
proceed	permission
dig	dig, digging, dug
crater	crater
wash	wash, washing, water
light	light, lighting, lit
shit	shit
throw	throw, throwing, throws, thrown, threw
boom	boom, bang
upload	upload, uploading, use, usage
reform	reform
divine	divine
mend	mend, misuse
satisfy	
predict	prediction, predict, predicted, predictive, predicting, predictions
myself	misuse, meme
convict	convict, conviction, convicted, conspiracy
litter	litter
progress	progress, performance, permission
RIP	rip
more	more
discover	discovery, discover
boot	boot
design	design, designer
divide	divide, division, definition, dividing
herself	
police	police, possession
vent	vent
okay	okay, ok, offensive
rupture	rupture
rage	rage, revenge
capture	capture, capturing, captures, captured
shudder	shudder, shaking
reach	
fix	fix
bless	blessing, bless, blessed, blessings
box	box, boxed, boxing, boxes, block
handle	handling
conquer	conquer, conquest
after	after
court	contempt
control	control, coercion, controlling
shove	shove
likely	likely, likelihood
rape	rape
stall	stall
list	list, lists
if	if, it
hail	hail, hacking
scale	scale, scaling, size
paint	paint, painting
lay	lay, laying, laid
balloon	balloon, balloons, bubble
unravel	use
mate	mating, mate, match
fill	fill, filling, fills
rent	rental, rent, renting
vary	variable, variance
enjoy	enjoyment, enjoy
fine	fine, fined
doubt	doubt
cop	cop
referee	referee
betray	betrayal, betray, betrayed
host	hosting, host, hosts, hosted, https
scan	scanning, scan, scans, scanner, scanned
embrace	embrace, embracing
home	home, house
protect	protection, protect, protected, protecting, protective
overlap	overlap, overlapping
dawn	dawn
good	good
Win	win, winning
decay	decay
that	that, this
reboot	reboot, restart, reset
boast	bragging, boasting, boast
crawl	crawl, crawling, crawled, craw
man	man, meme, misuse
receive	receive, receiving, request
conclude	closure
resume	resume, return, restore, resumes, restart
put	put
blind	blindness, blinding, blind, blinded
resurrect	resurrection, resurrect, resurrected, revival, revive
flow	flow, flows, flowing, function
farm	farm, farming, farmland
defend	defend, defense, defending
all	assert, abuse, all
trump	trump
her	
he	he
reproduce	reproduction, reproduce, reuse, replication
riot	riot, riots
press	press, pressing
skyrocket	
breed	breeding, breed
echo	echo
so	so
photograph	photography, photo, photographic, photograph
face	face
recoil	recoil
bowl	bowl, bowls, bowling
arrest	arrest, a
stare	stare, staring
unite	unity, unification, unite, use, union
trust	trust, trusting, this
drift	drift, drifting
tread	tread, trespass, that, this
gasp	gasp, gag
spell	spell
beam	beam, beams
beware	
mobilize	mobilization, mobilize, mobilized, mobil
no	
bring	
curl	curl
fuse	fuse, fusion, fire
wins	win, wins, winning
scoff	scoff
cum	cum, climax
clear	clearing, clear
trigger	trigger, triggering, this, the
hike	hiking, hike
hell	hell
chip	chip, chips
verify	verify, verification, verified, verifying
shake	shake, shaking, shook, shakes
once	once
reason	reason, reasoning
twitch	twitch, this, that
applaud	applause, applaud, applauded
operate	operation
solo	solo
self	self
integrate	integration, integrate, integrating, it, integrated
perhaps	
teleport	teleport, teleportation, this, that, tele
convince	coercion, convincing
record	record, recording, records
sound	sound
upgrade	upgrade, upgrading, use, usage, update, upgrades
this	this, that
life	life
baby	
shower	shower, showers
wind	wind
pack	pack, packing, possession
however	
tip	tip, tipping, tipped, tips, this, that
project	project
anyways	abuse
repay	repayment, repay
sob	sob, sap, screaming
reject	reject, rejection, rejecting, rejected
duck	duck, dodge, dunk
broadcast	broadcast, broadcasting
delay	delay, delaying, delayed, delays
inform	inform, it
slice	slice, slicing, slash, slices, sliced
communicate	communication, communications, communicate, communicating
copy	copying, copy, copied, clone
hand	hand
mature	mature, maturity
contend	
wed	wed
stray	stealing
dress	dressing, dress
observe	observe, observation, observing, observed, observer
peak	peak, performance, power, peaked
deny	denial, deny, denying, defamation
compare	comparison, compare, comparing, comparisons
storm	storm
restore	restore, restoring, restoration, restored, restores, recovery
restart	restart, reboot
charm	charm
stone	stone, slash
code	code
deflect	deflect, defamation
won	
tumble	tumble, this, that
feature	feature, function, features
appreciate	appreciation, appreciate
time	time, this, timeout
fare	fair
else	
dictate	definition
cause	cause
depend	derivative
what	what, when
fumble	fumble, force
hover	hover, hovering
hug	hug, hugging, handshake
harvest	harvest, harvesting, harvested
piss	piss, pee
abort	abort, abortion, aborted
space	space
orbit	orbit, orbital, orbiting, orbits
brew	brew, beer, brewing, brewer
supply	supply
rescue	rescue, rescuing
compute	computation, compute, computing
on	
allow	a
frown	frown
rewrite	rewrite, rewriting, reuse, re
engage	engagement, engage, engaging, engaged
divorce	divorce
defeat	defeat, defeating
fear	fear
often	often
impress	it, imp, impress, imitation
yes	yes
OK	ok, okay
name	name
delete	delete, deletion, deleting
strip	stripping, strip
both	both
boil	boiling, boil, boiled, boils
lift	lift, lifting, lifted, lifts
moan	moan, moaning
summarize	summarize, summary
weld	weld, welding
challenge	challenge, challenging
review	review, reviewing, reviews
pretend	pretend, pretending
down	down
achieve	a
request	request, requests
long	long, length, l
thing	that, thing, this
succeeded	
rush	rush, rushing
flock	flock
homer	homer, hitting, hit
by	
weigh	weight, weigh, weighing, weighed
defect	defect, deception
party	party, partying, parties
distract	distraction, distract, distracting, diversion, distracted, distractions
cool	cool, cooler, creative
recruit	recruiting, recruitment, recruit
sniff	sniff, smell, search
align	alignment, align, aligned, a
immediately	it, instant
fret	fret
empty	empty
transition	transition, transitions, transitioning, transfer, this, transformation
infect	infection, infect, infected, it, infections
day	day, days
itch	itch, itching, it
forfeit	forfeit, forfeiture
sense	sense, sensing
evacuate	evacuation, evacuate, evac, emergency, escape
top	top, this, that
them	that, theft, this
demand	demand
pretty	pretty
cap	cap, caps
abide	abuse
girl	girl
nest	nest, nesting, nests
commute	commute, commuting, commuter
key	key, keys
BE	be
patrol	patrol, patrolling
create	create, creation
hopefully	
shock	shock, stun
seem	
present	
capitalize	capitalize
file	file, filename, fs
guard	guard, guarding
am	a
solve	
just	
we	we
head	head, heads
breakdown	breakdown, break, breaking
drip	drip, dripping
off	off
discriminate	discrimination, defamation
accelerate	acceleration, accelerate, accelerating, accelerated
chew	chewing, chew, che
invest	investment, it, investing, invest, income
bullshit	bullshit
spend	spend, spending
spin	spin, spinning, spins, spun
flash	flash, flashing, flashed
God	god
mount	mount, mounting
snowball	snowball, snow
jog	jog
compromise	compromise, cheating, coercion
alone	abuse
Fail	fail, failure, failing, failed, fails
retract	retract
collide	collision, collide, crash, collided
foul	foul
freelance	freelance, freel
wolf	wolf
guarantee	guarantee, guaranteed, guarantees
repeal	repeal
misunderstand	misuse, misunderstand, misunderstanding
taste	taste, tasting, this
address	a, an
sway	sway
repair	repair, repairing, restoration, repairs, recovery
wrong	wrong, wrongful, wrongly
campaign	campaigning, campaign
to	this, the
anchor	anchor, a, anchors, an
venture	venture
definitely	
renew	renewal, renew, renewed
download	download, downloading, downloads
even	
derail	derail, disruption, derailed, destruction
vacuum	vacuum
answers	a
contract	contract, contracting
phone	phone
rethink	
unfold	use, usage
bike	bike, biking, bicycle
chat	chat, chatting, communication
steer	steer, steering
coin	coin, currency
recharge	recharge
two	two, three, this
abound	abuse
manifest	manifest, manifestation, manifested
worsen	
piece	piece, pieces
school	school
reopen	reopen, reuse, ransomware
enough	
Posted	
DJ	dj, dance
migrate	migration, migrate, migrating, move, mv
way	way
torture	torture, this, tort, terrorism
invite	invitation, invite, inviting, it
crest	crest
define	definition, define, defining
WIN	win, winning
disband	destruction, disband
surely	
survived	
license	license, licensing
there	that, this, there
year	year
pale	
OD	od, op
advise	advice, advise, advising, abuse
Survive	
consider	consider
type	type, this, typing
separate	separation, separating, separate
skip	skip, skipping, slash, skipped
drag	drag, dragging, dragged
spot	spotting, sighting
sunset	sunset
most	most, misuse
reside	residence
expect	expect, expects, expectation, expected, expecting
college	cheating, college
order	order, ordering
lock	lock, locking
rear	rear
quote	quote, quoting, quotation
interview	interview, it
away	
son	
bald	
might	might, may
stitch	stitch, stitching, stitches
stump	stump, slash, slug, spam
course	
over	over
Cry	cheating, cry
she	
grace	grace
swoop	swoop, swat, sweeping, stealth
support	support, supporting
lecture	lecture, lecturer, language
debate	debate, discourse, debating
reap	reap
themselves	theft, this
stew	stew
trade	trade, trading, this
known	know
dot	dot
malfunction	malfunction, misuse
lack	
avail	abuse
yawn	yawn
consent	consent, coercion
brawl	brawl
reflect	
pursue	pursuit
proof	proof, predicate
speed	speed, speeding
place	place
sketch	sketch
quickly	quick
plot	plot, plotting
trick	trick, this, tricks, that
invade	invasion, invade, invading, intrusion, invaded, it
gamble	gambling, gamble, gaming
determine	definition
coast	coast, cheating, cyber
latch	latch
gel	gel, glue, gelatin
stroke	stroke, strokes
opt	opt, opting
brain	brain, brains
eclipse	eclipse
sour	sour
badly	bad
perfect	perfection, perfect, performance, practice
loot	loot, looting, looted
mix	mix, mixing, mixer
shovel	shovel, snow
parent	parent, parenting, parental
elect	election, elect
zero	zero
rocket	rocket, rockets
filibuster	filibuster
shred	shred, shredded
expose	expose, exploit
reconnect	reconnect
nail	nail
s	s
ignite	ignite, it, ignition, incendiary
mail	mail, mailing
dispute	dispute, disputed, defamation
circulate	circulation, circulating
dust	dust, dirt
size	size, sizing, scale
mushroom	mushroom, mushrooms
dwell	dwelling, dwell
Skype	skype
sprint	sprint
grate	grate
override	override, overriding
white	white
fib	fib, fraud, false
mother	mother
crow	crow
weather	weather
harm	harm
reward	reward, rewarding
a	a
spew	spew, speech, spam
revive	resurrection, revive, revival, revived, resurrect, regeneration
replace	replace
punt	pun, punt, pat
blast	blast, blasting
Live	live, life
scroll	scroll, scrolling
provoke	provocation, provoke
represent	
slam	slam, slamming, slams
alert	alert, alerts, alarm
email	email
red	red
stack	stack, stacking, stacks
spar	spar
fulfill	function
desert	
pin	pin, pins, pinned
father	father
track	tracking, track, tracker, tracked, this
job	job
ensure	
innovate	innovation, invention, it, innovate, innovative
late	late
flag	flag, flags
sober	sober
zip	zip, z, zipper
fuel	fuel, fire
heat	heat, heating, hot
acknowledge	acknowledge, acknowledgement, a
troll	trolling, troll, this, trolls
heart	hate
gather	gathering, gather
negotiate	negotiation, negotiating
gold	gold
maintain	maintain
tattoo	tattoo, this, tattoos, that
revise	revision, revise, rewrite, reuse
brake	braking, brake
activate	activation, activate, a
parachute	parachute
second	second
lost	lost, lose, loss
sample	sampling, sample, samples
ultimately	use, usage
surf	surfing, surf
sometimes	
exercise	exercise, exercising
easily	
honor	honor, honoring
Sunday	
include	it
tackle	tackle, the, this
cruise	cruise, cruising
sir	
single	single, sum
at	a
Be	
ID	id, identifier, identification, identity, it
ready	ready, readiness
blank	blank, block, blocking
redirect	redirect, redirected
yellow	yellow
none	
earn	earn, earning, earned
illustrate	illustration, it
recommend	recommendation, recommend, recommending, recommendations
inevitably	it
converge	convergence, converge, coordinate
dive	dive, diving, diver, dives, dunk
wit	wit
soul	soul, spirit, slash
rake	rake, redirect
sag	sag, sig
approach	a
influence	influence, influencing
Miss	mv
park	parking, park, permission
trace	trace, tracing, this, traces, tracking
ha	ha, hacking
await	await, async, assert, a
jar	jar
gone	
document	document, documentation
grab	grab, grabbing, grabs
partake	possession, partake, participation
disconnect	disconnect
literally	
flirt	flirt
surpass	success
guide	guide, guiding, guidance
Wed	
delegate	delegate, delegation, delegated
deserve	deserve, deserving
commence	
Google	google
entertain	entertainment, entertain, entertaining
wanna	
cast	casting, cast, casts
accomplish	a
persuade	persuasion, persuasive, propaganda, persuade
chant	chant, chanting
govern	government, govern, governance
diminish	defamation
unveil	use, usage
bottle	bottle
interpret	interpretation, interpret, it
sustain	sustain, sustainability, sustainable
draft	draft, drafting, drafts
educate	education, educational
counter	counter
bind	bind, binding, bound
warn	warning, warn, warnings
narrow	narrow, narrowing, narrower
explore	exploration, explore, exploring, expression
calculate	
premiere	premiere, parody
seize	seizure, seizing, seize, seized, stealing
flame	flame, fire, flaming, fuse
drone	drone, drones
bat	bat, batting, base
recite	
sooner	
fruit	fruit, fruits
night	night
bluff	bluff
bob	bob
gag	gag, gif
war	war, warfare, wartime
hint	hint, hints
tick	tick, this, that, trigger, triggering
creep	creep, creepy, creeping
detect	detection, detect, detecting
consume	consume, consumption, consumed, consuming, consumes
amend	amend, amendment, appropriation, a
disclose	disclosure, disclosing, disclosed, disclose, disclosures
detail	detail, description, describe, details
bother	bother, bullying
stress	stress, stressed, stressful
LIVE	life, live
flush	flush, flushed
dim	dim
conflict	conflict, coercion
rat	rat
lol	lol
imagine	imagine, it, imagination
organize	organizing, organization, organize, organized
bid	bid, bidding, bidder, bids
ghost	ghost, ghosts
cancer	cancer
ice	ice, it, icing
Blink	blink, blinking, blocking
rescind	
recycle	recycling, reuse, recycle, recycled
erase	erase, erased
permanently	permission, property
brother	
avoid	avoidance, a, abuse
bill	bill, billing
dock	dock, docking, discharge, docks
remove	removal, remove
NOT	not
sort	sort, sorting
suicide	suicide, suicidal
roam	roaming, roam
concentrate	concentration, concentrate, concentrating
Saturday	spam
bankrupt	bankruptcy, bankrupt
climax	climax
yesterday	
knit	knitting, knit
stabilize	stabilization, stabilize, stability, stable
coincide	coincide, conjunction, coordination, coincidence
load	load, loading, loader, loaded
labor	labor, labour
soldier	
conceive	conception, conceived
truth	truth, true
trumpet	trumpet, trump, this, that
contest	contest, cheating
purge	purge, pur
Pass	pass, passing
ya	
cake	cake
revenge	revenge, retaliation, retribution
screw	screw
bump	bump, block
absorb	absorption, absorb, absorbing, amplification, acquisition
upset	use, upset
truck	truck, trucks, this, that
spare	surplus, spare
aid	aid, assistance, assist, a
reset	reset, reboot
warm	warm, warmth, warming
raise	raise, raising
worship	worship
rather	
stalk	stalking, stalk
spiral	spiral, spin
lives	life
fal	
decipher	dictionary
criticize	criticism, criticizing
defer	defer, delay, deferred, def
disembark	disembark
thin	thin, thickness, thinner, thick
color	color, coloring
salute	salute, such
ad	ad, advertising, ads, advertisement
shot	shooting, shoot, shot
retrieve	retrieve, return
don	
fat	fat, fatty, fats
flower	flower, flowering, flowers, foliage, floral
delight	delight
frost	frost, freezing, freeze
weaken	
slot	slot, slots, sizeof
juice	juice
boycott	boycott, boycot, bds
grave	grave
sneak	stealth, sneak, sneaking, stealing, steal
twist	twist, twisting, twisted, this
STOP	stop, stopping
waiver	
scrape	scraping, scrape, scrap
another	abuse, a
best	best
some	
otherwise	
intercept	intercept, interception, intercepted, it
quake	quake
spy	spying, spy, surveillance
sub	sub
specialize	specialization, specialize, special, specialized
why	why
surge	surge, spike, surges
Sue	
breach	breach, breached, breaching, break
welcome	welcome, welcoming
impact	impact, influence, it
three	three, two, this, triple
smack	smack, slap, slapping
re	re, reuse, r
scoop	scoop
done	done, do, did, does
something	
cold	cold
consult	consulting, consultation, consult
peel	peel, peeled
trial	trial, this, test
grunt	grunt
dope	dope
RT	rt, retweet, r
slap	slap, slapping, slash, smack
nothing	nothing
final	final, fatal, function
require	require
prey	prey, predatory, predator
alter	alteration, abuse
chose	choice, choosing, choose
lag	lag, latency, l
journey	
film	film, filming, footage
because	
tend	this, that, the
force	force, forcing
worse	
mark	mark, marking, marks, marker, marked
ly	ly
parole	
neither	
chase	chase, chasing, catch, chased
boo	boo, bo
insult	insult, insulting, it, insults
implant	implant, it, implants, infection, injection
kids	
aim	aim, aiming, arrow, aimed
research	research
mesh	mesh, meshes
smear	smear, slander, slur
root	root
probe	probe, probing, probes
children	child
glory	glory
somewhere	something
thrill	thrill, this, that, threat
mistake	mistake
branch	branch, branching, branches, block
tower	tower, this, that
triple	triple, this
sin	sin
response	response, respond, reply
family	family
radio	radio
co	co, coercion
clot	clot, consumption
embarrass	embarrassing, embarrassment
select	select, selection, selecting
orgasm	orgasm
success	success, successful
affect	a, abuse
suggest	suggestion
when	when
prefer	preference
thunder	thunder, this, that
heel	heel
lament	lament
w	w
but	
wheel	wheel, wheels
mention	
instruct	instruction, instruct
passed	
tank	tank, this, that
bad	bad
victory	victory
discuss	discussion
company	
overthrow	overthrow
did	did, do, done, does
heed	
substitute	substitution, substitute, substit
dice	dice, die
claw	claw, claws
hum	hum, humming
heaven	heaven, hell
each	
breast	breastfeeding, breast
Maybe	
penetrate	penetration, penetrating
exceed	exceed, exceeding
intensify	it
wax	wax
bubble	bubble, bubbles, burst
transcend	transcend, the, this
shoulder	shoulder
strut	strut, stunt, style
twins	this
factor	factor, f
silence	silence, speech
comfort	comfort
obviously	
speculate	speculation, speculative, speculate
tweak	tweak, this, tweaking
advocate	advocacy, advocate, appropriation, activism
pose	pose, posing, posed, poses, photo
rate	rating, ranking, ratings
thanks	this, that
blaze	burning, blaze
knows	
buck	buck
describe	definition
snack	snack, snacks
fork	fork, forks
spark	spark, sparking
specify	
parse	parse, parsing
fake	fake, fraud, false
pour	pour, pouring, poured
glare	glare, glaring
itself	it
price	price, pricing
mom	mom, meme, mother
Monday	meme
chance	chance, coincidence, cheating
Tony	this, that
export	export, exports, exporting, exported
realise	
unlock	use, unlock, unlocking
plug	plug
stretch	stretch, stretching, stretched
personally	personal
nonetheless	
tel	tel, this, that, the
reckon	
week	
disrupt	disruption, disruptive, disrupt, disrupting, destruction
administer	abuse, administration, a, administering
smash	smash, smashing
person	
enlarge	enlarge
before	before
simmer	simmer, sauce
Friday	friday
presume	
remains	
adhere	abuse, appropriation
prize	prize, profit
sheep	spam
KO	ko, kill, k, knockout
distort	distortion, defamation, distort, disinformation
pardon	pardon
prioritize	prioritize, priority
el	el
assemble	assemble, assembly, a, assembling
seed	seed
threaten	threat, threatening, threats, threaten, threatened
anymore	abuse
suppose	suppose, statement
scout	scouting, scout, scouts
people	
dad	
crush	crush, crushing
crown	crown, copyright
through	this, the, that
intersect	intersection, intersect, it, interaction
runaway	
spear	spear, spears, slash
dissent	dissent, defamation
audition	audition, acting
stream	stream, streaming, streams
shutter	shutter, shooting
wee	wee
hitch	hitch, hook, hacking
rust	rust
seat	seat, seating, seats, space
bottom	bottom, block
flare	flare, flares, flared, fuse, flaming
weave	weaving, weave, warp
spray	spray, spraying, sprayed
revel	
stain	stain
big	big
apprentice	apprentice
U	u, use, usage
invent	invention, innovation, invent, invented, it
moon	moon, moons
remake	remake, reuse
iron	iron, it
brood	brood
zoom	zoom
equal	equality
wrap	wrap, wrapping, wrapper, wrapped, wraps
Earth	earth
ease	ease, easing
boys	bullying
assassinate	assassination
apparently	a
condemn	condemnation
couple	couple, coupling
barbecue	barbecue, bbq, burning, burn
March	meme
milk	milk, manure
encounter	encounter
summon	summoning, summon, summons
blitz	blitz
al	al, abuse, a
seek	seek, seeking, search
Rock	rock, r
flap	flap, fly, flying, flag
stuff	stuff, something
for	
whatever	whatever
fuss	
effect	effect
duel	duel
short	short, slash
strive	success, strive, striving, something
occupy	occupying, occupy, occupation
slaughter	slaughter
rub	rub, rubbing, rubbed
bar	bar
redeem	redeem, redemption, redeemed, reuse
plea	
dodge	dodge, dodging
plant	planting, plant, planted
DO	do
crop	crop, cropped
since	
obsess	obsession, obsessive, obsess
exhibit	expression
trans	trans, transgender, this
revisit	
flesh	flesh
hedge	hedge, hed
house	house, housing
refill	refill, reuse, recharge
install	install, it, installation
snake	snake, slime, slash, slang
minister	misuse, meme
remind	remind, remember, reminder
percent	
human	human, humanity
ignore	ignoring, ignore, it
kind	kind
fell	
alright	abuse
calm	calm, calming, chaos
usually	use, usage
retake	
justice	justice
filter	filter, filtering, filters, filtered
brown	brown, burn, burning, bleach
analyze	analysis, analyze, a
quarrel	quarrel
treat	treat, treatment, this
interact	interaction, interact, it, interface, input
accidentally	accidentally, accidental, a, an
birth	birth
scratch	scratch, scratching, scraping, screenshot
aspire	aspiration
Wrestle	
or	
comeback	cheating
trespass	trespass, tresp, theft
sack	sack, sacks, slash
retain	retention, reuse
issue	it, issue
vacation	vacation, vacations
grasp	grasp, grasping
recap	recap
plunge	plunge, plung
butt	butt
mold	mold, mould, modification
ash	ash, ashes
great	great, good, greatness
grade	grading, grade
label	label, labeling
master	mastery, master, magic
certainly	
link	link, linking, links
credit	credit
dose	dose, dosage
attract	attract, a, attracting, attraction
jet	jet
Jack	
tag	tag, tagging, tags, this, tagged
fool	fraud
rotate	rotation, rotate, rotating, rotated
mislead	misleading, mislead
uphold	use, usage
pit	pit, pits, pun
Read	read
egg	egg, eggs
naturally	
degrade	degradation, degrade, degrading
pulse	pulse, pulses, puls
tap	tap, tapping, this, touch, that
number	number
deter	deter, deterrence
action	action, a
ramp	ramp
others	
owe	owe, owed, owes, owing
completely	cheating
exactly	
overturn	overturn
dwarf	
injury	injury, injure, it, injured
advertise	advertising, advertisement, ad
cow	cow, cows
breath	breathing, breath
pant	pant, poop, pun
gossip	gossip
parade	parade
purchase	purchase, purchasing, payment
differentiate	differentiation, definition, defining, difference, distinction, differentiated
bastard	
pen	pen
scrap	scrap, scraping
combine	combine, combining, combined
Mars	mars, martian, mining
amount	amount, a
grind	grind, grinding, gaming
recently	
bully	bullying, bully, bullies
PR	pr
bank	bank, banking
Phoenix	
display	display
November	
missed	misuse, meme
inside	it, inside
extend	extension, extend, extends, extending, extended, extensions
moderate	moderation, moderate
moment	moment, meme, meaning
swat	swat, slash
whiff	whiff
guys	
changed	
years	
damage	damage, destruction, damaging
ban	ban, banning, bans, blocking
his	
almost	a
Do	do, done
cater	
process	processing, process
brief	brief
cluster	cluster, clusters, context
motivate	motivation, motivating, motivate, motivational, motiv, motivated
mess	mischief, mess, misuse
coordinate	coordinate, coordination, coordinates, coordinating
infiltrate	infiltration, infiltrate, intrusion, it
deceive	deception, deceit, deceptive, deceive
LOL	lol
bang	bang, banging, boom
wow	wow, what
scare	scare
illuminate	illumination, illuminating, it
amplify	amplification, amplify, amplified
exchange	exchange
overwhelm	overwhelm, overload
of	
pivot	pivot, piv
glitch	glitch, glitches
decode	decode, decoding
blend	blending, blend, blended, blends
contact	contact, communication
bury	burying, burial
broken	
monitor	monitoring, monitor
ticket	ticket, tickets, this, that
prick	prick, pr, piercing
season	season
transplant	transplant, this
GO	go, g, get
food	food
is	it
subpoena	subpoena, surveillance, seizure
drill	drilling, drill, dig, digging
login	login
lap	lap, laps
deepen	
shy	slang
error	error, errors
gorge	gorge
Lord	
sled	sled, snow, shovel
alive	alive
Not	not
evade	evade, evasion, escape
drain	drain, draining, discharge
Jeff	
flight	flight, flying, fly
b	b
crib	
trail	trail, tracking, track, tracker, trace, this, trails
cream	cream
squat	squat, squats
Steve	
ex	ex
ed	ed
everything	everything
hook	hook, hooks
inquire	it, inquiry, inquire
NEVER	
comprehend	comprehension
sport	sport, sports
slash	slash, slashing
promote	promotion, pr, propaganda
bag	bag, bags
least	
church	church
port	port, ports
attach	attach, attaching, attachment, an, a
woo	woo
swap	swap, swapping, swaps
blue	blue, block
ok	ok, okay
trouble	trouble, that
ten	ten, this
endorse	endorsement, endorsing, endorsements, endorse
may	may
grown	growth
appropriate	appropriate, appropriation, a
S	s
Rebel	
phase	phase, phases
throttle	throttle, this, that
loss	loss, losses, lose
sip	sip
condition	condition, conditional, conditions
meltdown	meme, meltdown
dash	dash
forward	forward, forwarding
would	
friend	friend, friendship, friends, friendly
Greg	
honey	honey, hex
old	old
rarely	
reconstruct	reconstruction, reconstructed, reconstruct
case	case, cases
fails	
t	t, this
few	
early	early
sure	
abuse	abuse, abusive, abusing, abused
adventure	adventure
pencil	pencil, pen
captain	
harass	harassment, harass, harassing
punk	punk, pun, prank
round	round, rounding
directly	direct
compost	compost
prod	prod, poke, push, pr
squeeze	squeeze, squeezing, squeezed, squee
farewell	
fray	flaming, foul
everyone	
vest	vest
hammer	hammer, hamm
shape	shape, shaping
failure	failure, failing, fail, failed
dial	dial
Tell	that, t, this, tell
employ	
validate	validate, validation, verify, verification
pro	pro
within	
chop	chop, chopping, cutting, cut, chopped, chops
grip	grip, gripping, grab, grasping
journal	journal
quiz	quiz
team	team, teamwork, this
poison	poison, poisoning
sentence	sentence
induce	it
voice	voice
amp	amp, amplification, amplifier
ret	ret, rt
sick	sick, slime, sickness
green	green
audit	audit, audits, auditor, a
ry	r
incite	incite, inciting, it
Go	go
confront	
bleach	bleach
worm	worm, worms
ta	this, that, the
Rule	rule
haha	
quiet	quiet
crowd	crowd, cc, crowdfunding
lick	licking, lick
inevitable	it
model	model, modeling
overflow	overflow, overload, overfl
Pop	pop
twice	this, that, twice
counsel	counsel
treasure	treasure, theft
album	album, appropriation
render	render, rendering, rendered
undo	undo, use
future	future
forgotten	
thereafter	this
Twitter	twitter, tweet, tweeting, this, that
award	award, awards, awarding, a
air	air, airspace
implement	implementation, implement
rig	rig, rigging
instantly	instant, it, instantly, instantaneous
chain	chain
pine	pine
cage	cage, capture
warp	warp
ferment	fermentation, ferment, fermented
medal	medal, medals
blood	blood, bleed
hour	hacking
correspond	
drunk	drunk, drinking, dui, drink, drunken
inject	inject, injection, injecting, injected, it, injections
page	page
amuse	amuse, amusement
scramble	scramble, scrambling, scrambled
revolution	revolution, revolutionary, revolutions
happy	happy, happiness
less	
populate	
o	o
shutdown	shutdown
limit	limit, limits
pan	pan
sand	sand, sands
er	er
grant	grant, granting
surgery	
bullet	bullet, bullets
kickoff	kickoff, kick, kicking
Know	know, knowledge, knowing
jazz	jazz, jam
exhaust	exhaust
widen	
O	o
five	five, four
ov	ov
respect	respect
entirely	
publicly	public, publicly
shuttle	shuttle
transgress	trespass
must	
borrow	borrow, borrowing, borrowed
tears	this, tears, that
Rise	rise
recount	recount, recounts, record
Christian	cheating
max	max, maximum, maximal, min
diet	diet
wet	wet, water
il	it, il
brush	brush, brushing, brushes
and	a, and
pink	pink, purple
reassure	reassure
reiterate	
streak	streak, slash
poke	poke, poking, poked
bunk	bunk
yourself	
Israel	it, illegal, israel
interest	interest, it
limp	limp
class	class
Follow	follow, following
app	app, application, api
gay	gay
pace	pacing, pace
recognise	recognition
stock	stock, share
should	
lunch	lunch
things	this, that
pastor	pastor, preaching
hop	hop, hops, hopping
soil	soil
quite	
sup	sup
much	misuse
correlate	correlation, correlate, causation, context
bites	
animate	animate, animation, animated, anim, a
tan	tan, this, that
contain	
waste	waste, wasting, wasted
hem	
crew	crew
stagger	
Trump	trump, this, that, treason
toss	toss, throw, throwing, tossing, trash, this, threw
DC	dc, d
rampage	rampage
thought	that, this, thinking
redesign	reuse, redesign
simply	
hij	hacking
divest	divest
reclaim	reclaim, reclaimed, reuse
target	target, targeting, this
career	
gladly	
happened	happen, happened
dip	dip, dipping
